what is the sex of <e> 's darling	joseph_e_davies	female
what is the son of offspring of <e>	chulalongkorn	nakkhatra_mangkala_kitiyakara
why <e> 's dad died	postumus_junior	assassination
the location of daughter of <e>	john_elector_of_saxony	coburg
the cause of death of <e> 's spouse	adolf_hitler	suicide|cyanide_poisoning
who is the other half of <e> 's father	isabella_of_france	joan_i_of_navarre
what is <e> 's father working on	mette_marit_crown_princess_of_norway	journalist
what is the gender of mom of <e>	catharina_of_sweden	male
the gender of <e> 's mother	philippine_elisabeth_of_orleans	male
what sex is <e> 's kid	alexander_ferdinand_3rd_prince_of_thurn_and_taxis	male
what is the dad of <e> 's child	gustavus_adolphus_of_sweden	maria_eleonora_of_brandenburg
what is the nation of <e> 's children	maria_of_brabant	france
what is the gender of <e> 's offspring	artavasdes_i_of_armenia	male
the sex of son of <e>	maximilian_i_of_bavaria	male
why <e> 's mom died	penelope_blount_countess_of_devonshire	dysentery
the place of death of <e> 's mom	william_ii_german_emperor	potsdam
what is the <e> 's darling 's mom	georg_donatus_hereditary_grand_duke_of_hesse	prince_andrew_of_greece_and_denmark
what is the institution of son of <e>	william_talbot	oriel_college
where does <e> 's husband come from	sybil_thomas_viscountess_rhondda	wales|united_kingdom
the sex of <e> 's other half	juba_ii	female
the children of <e> 's offspring	jahangir	dara_shikoh
what is the <e> 's parents 's sex	princess_sophia_dorothea_of_prussia	male
what is the name of the offspring of <e> 's parent	lady_sarah_wilson	lord_randolph_churchill
the sex of wife of <e>	huey_long	female
what is the <e> 's mom 's institution	rasmus_bartholin	university_of_copenhagen
<e> 's son 's father	mumtaz_mahal	mumtaz_mahal
the parents of <e> 's spouse	juliana_maria_of_brunswick_wolfenbuttel	sophia_magdalen_of_brandenburg-kulmbach
what is the dad of child of <e>	gustavus_adolphus_of_sweden	maria_eleonora_of_brandenburg
the nationality of parent of <e>	robert_c_wickliffe	united_states
<e> 's parents 's gender	artabastos	male
what is the sex of <e> 's couple	lew_cody	female
who is the spouse of <e> 's husband	mary_anna_custis_lee	mary_anna_custis_lee
the work of wife of <e>	ernest_hemingway	journalist
what is the father of children of <e>	henry_iii_holy_roman_emperor	henry_iii_holy_roman_emperor
what is the father of <e> 's children	henry_iii_holy_roman_emperor	henry_iii_holy_roman_emperor
who is the child of <e> 's mom	gaston_comte_deu	gaston_comte_deu
what is the place of death of mother of <e>	william_kissam_vanderbilt	new_york
what sex is <e> 's wife	james_hepburn_4th_earl_of_bothwell	female
the wife of <e> 's other half	arleen_whelan	arleen_whelan
which institution does <e> 's child work for	victoria_of_the_united_kingdom	trinity_college_cambridge
the cause of death of father of <e>	louis_xvi_of_france	tuberculosis
what is <e> 's child 's ethnicity like	major_ridge	cherokee|native_americans_in_the_united_states
what does <e> 's kid do for a living	thomas_thynne_2nd_viscount_weymouth	politician
<e> 's dad 's nationality	lynn_redgrave	united_kingdom
the faith of <e> 's husband	marie-anne_pierrette_paulze	anglicanism
<e> 's darling 's place of death	elizabeth_allan_1908	new_york
what is the ethnicity of <e> 's heir	alice_betty_stern	germans
what gender is <e> 's parent	thutmose_iv	male
the other half of daughter of <e>	grand_duchess_alexandra_petrovna	anastasia_of_montenegro
the dad of children of <e>	charles_spurgeon	charles_spurgeon
what is the name of the heir of <e> 's couple	maria_luisa_of_savoy	mariana_victoria_of_spain
what is the address of couple of <e>	robert_lowell	london
is <e> 's kid a man or a woman	frank_lloyd_wright	male
where did <e> 's offspring die	constantine_viii	constantinople
the occupation of other half of <e>	ekaterina_svanidze	generalissimo
what is the nation of <e> 's father	catherine_carey	kingdom_of_england
what is the heir of parent of <e>	catherine_of_braganza	teodosio_prince_of_brazil
the sex of parents of <e>	tyrone_power	male
where does <e> 's son work for	john_b_kelly_sr	american_academy_of_dramatic_arts
the sex of parents of <e>	princess_sophia_dorothea_of_prussia	male
what is the cause of death of son of <e>	anton_philips	accidental_fall
what is the name of the husband of <e> 's heir	philip_v_of_spain	joseph_i_of_portugal
is <e> 's child a man or a woman	wang_khan	female
what is the kid of <e> 's parents	qianlong_emperor	qianlong_emperor
what is the nation of <e> 's parent	edward_of_norwich_2nd_duke_of_york	kingdom_of_england
what faith does <e> 's son practice	christiane_eberhardine_of_brandenburg_bayreuth	catholicism
<e> 's other half 's gender	anne_of_bohemia	male
the mom of <e> 's mom	stephen_i_of_hungary	taksony_of_hungary
<e> 's mom 's parents	lady_may_abel_smith	princess_helena_duchess_of_albany
the sex of <e> 's husband	henrietta_anne_stuart	male
what is the nationality of <e> 's dad	titus_van_rijn	netherlands
the gender of mom of <e>	george_formby	male
what is <e> 's son	marvin_pentz_gay_sr	composer|record_producer
what is <e> 's other half	elizabeth_of_york	monarch
the nation of father of <e>	catherine_carey	kingdom_of_england
where does <e> 's parent come from	robert_c_wickliffe	united_states
the nation of parent of <e>	edward_ellice_1810	united_kingdom
what is the name of the mom of <e> 's mom	stephen_i_of_hungary	taksony_of_hungary
<e> 's darling 's nation	edwin_samuel_montagu	united_kingdom
what is the nation of offspring of <e>	sarah_lennox_duchess_of_richmond	united_kingdom
what is the <e> 's offspring 's gender	frederick_iii_german_emperor	female
which nationality is <e> 's wife	marie-anne_pierrette_paulze	united_kingdom|germany
<e> 's dad 's offspring	william_ii_german_emperor	princess_charlotte_of_prussia
the job of children of <e>	jawaharlal_nehru	politician
<e> 's spouse 's nationality	margaret_of_artois	france
who is the child of <e> 's parent	prince_feodor_alexandrovich_of_russia	prince_andrei_alexandrovich_of_russia
is <e> 's dad a man or a woman	lothair_of_france	female
what sex is <e> 's parent	louis_philippe_i_duke_of_orleans	male
what is the cause of death of couple of <e>	john_franklin	tuberculosis
what gender is <e> 's spouse	carlos_thompson	female
<e> 's offspring 's place of death	maria_luisa_of_parma	trieste
the gender of wife of <e>	verina	male
what killed the <e> 's dad	postumus_junior	assassination
the heir of <e> 's children	wang_khan	mongke_khan
the job of <e> 's spouse	doris_blackburn	lawyer
the parents of <e> 's child	anton_philips	anton_philips
what is the <e> 's kid 's sex	grand_duke_alexander_mikhailovich_of_russia	male
the child of children of <e>	albert_of_saxe-coburg_and_gotha	victoria_eugenia_of_battenberg|prince_maurice_of_battenberg
what is the <e> 's child 's nationality	geza_i_of_hungary	hungary
what is the <e> 's daughter 's location	louise_defeo	new_york_state
<e> 's child 's nationality	john_d_rockefeller_jr	united_states
the gender of <e> 's father	yixin_prince_gong	male
the gender of mom of <e>	mieszko_iv_tanglefoot	male
what is the nation of <e> 's offspring	louis_duke_of_nemours	france
what is the heir of <e> 's mother	frits_philips	frits_philips
<e> 's parent 's sex	claudius	male
the nationality of dad of <e>	lynn_redgrave	united_kingdom
what is the <e> 's mother 's gender	philippine_elisabeth_of_orleans	male
is <e> 's couple a man or a woman	phillip_terry	female
<e> 's mother 's sex	henry_of_portugal	male
where does <e> 's spouse come from	roger_needham	united_kingdom
the offspring of parent of <e>	lady_sarah_wilson	lord_randolph_churchill
what is <e> 's offspring working on	cosima_wagner	conducting|composer
the kid of father of <e>	charles_lennox_2nd_duke_of_richmond	charles_lennox_2nd_duke_of_richmond|anne_van_keppel_countess_of_albemarle
<e> 's son 's cause of death	marvin_pentz_gay_sr	firearm
is <e> 's child a man or a woman	jewna	male
what is the <e> 's child 's sex	p_j_kennedy	male
what is the sex of <e> 's darling	luis_munoz_marin	female
what is the <e> 's father 's sex	eadgifu_of_england	male
what is the job of father of <e>	elisabeth_of_austria_1526	holy_roman_emperor
the gender of <e> 's darling	roger_needham	female
what is the name of the mother of <e> 's son	louis_duke_of_nemours	louis_duke_of_nemours
what is the <e> 's couple 's cause of death	james_hepburn_4th_earl_of_bothwell	decapitation
where does <e> 's spouse work for	colleen_dewhurst	university_of_missouri_columbia
the cause of death of dad of <e>	justinus_van_nassau	assassination|firearm
which nationality is <e> 's parents	edward_salisbury_dana	united_states
what is the nation of <e> 's offspring	sarah_lennox_duchess_of_richmond	united_kingdom
the religious belief of <e> 's father	george_darwin	anglicanism|agnosticism
what sex is <e> 's husband	henrietta_anne_stuart	male
what is the nation of <e> 's wife	anahareo	canada|united_states
how <e> 's child died	adolf_frederick_of_sweden	firearm
what is <e> 's parents	skip_caray	sportscaster
what is the <e> 's dad 's offspring	william_ii_german_emperor	princess_charlotte_of_prussia
what is the <e> 's mother 's heir	charles_lennox_2nd_duke_of_richmond	charles_lennox_2nd_duke_of_richmond|anne_van_keppel_countess_of_albemarle
what gender is <e> 's husband	cecilia_renata_of_austria	male
the place of birth of <e> 's wife	adolf_hitler	munich
what is the <e> 's son 's cause of death	marvin_pentz_gay_sr	firearm
what is the sex of <e> 's dad	william_ii_german_emperor	male
what is the child of <e> 's mother	archduke_louis_of_austria	rudolf_cardinal_von_habsburg_lothringen|archduke_joseph_of_austria_palatine_of_hungary
what does <e> 's husband do for a living	colleen_dewhurst	actor
what is the child of parent of <e>	thomas_spurgeon	thomas_spurgeon
is <e> 's mom a man or a woman	mieszko_iv_tanglefoot	male
how <e> 's wife died	franz_joseph_i_of_austria	assassination
what is the profession of <e> 's parents	skip_caray	sportscaster
the place of birth of mom of <e>	anna_e_roosevelt	new_york
the nationality of kid of <e>	hortense_de_beauharnais	france
where did <e> 's mom born	henry_iii_of_france	florence
who is the parent of <e> 's son	anna_of_holstein-gottorp	enno_iii_count_of_ostfriesland
the cause of death of <e> 's couple	carole_lombard	myocardial_infarction
what is <e> 's kid working on	blessed_virgin_mary	carpenter
what does <e> 's father do for a living	elisabeth_of_austria_1526	holy_roman_emperor
the gender of couple of <e>	gaius_marius	male
<e> 's husband 's profession	roger_needham	computer_scientist
what is the spouse of mom of <e>	henry_i_duke_of_guise	jacques_de_savoie_2nd_duc_de_nemours
<e> 's offspring 's place of death	augustus_ii_the_strong	avignon
is <e> 's child a man or a woman	pierre_curie	female
the educational institution of husband of <e>	laura_devon	university_of_notre_dame|university_of_michigan
<e> 's offspring 's sex	charles_lennox_1st_duke_of_richmond	male|female
what is the child of parent of <e>	shah_shuja	shah_shuja
what is the cause of death of darling of <e>	mary_anna_custis_lee	pneumonia
what faith does <e> 's heir practice	jewna	paganism
what is the name of the husband of <e> 's mother	robert_i_duke_of_burgundy	constance_of_arles
where does <e> 's offspring come from	john_spencer_churchill_7th_duke_of_marlborough	united_kingdom|england
the son of <e> 's mom	john_ii_casimir_of_poland	alexander_charles_vasa
what is the nation of <e> 's parent	george_herbert_11th_earl_of_pembroke	united_kingdom
what is the sex of wife of <e>	mae_west	male
<e> 's heir 's cause of death	pedro_ii_of_brazil	yellow_fever
what did <e> 's child die from	maria_adelaide_of_austria	tyrannicide
is <e> 's couple a man or a woman	gaius_marius	male
is <e> 's kid a man or a woman	william_cavendish_bentinck_7th_duke_of_portland	female
where is <e> 's other half staying	auguste_van_pels	lower_saxony
what is the <e> 's offspring 's sex	charles_lennox_1st_duke_of_richmond	male|female
the place of death of <e> 's kid	princess_beatrice_of_the_united_kingdom	lausanne
the location of <e> 's parents	ray_bridwell_white	kentucky
what is the father of <e> 's son	mumtaz_mahal	mumtaz_mahal
what did <e> 's daughter die from	nicholas_ii_of_russia	murder|firearm
<e> 's mom 's heir	felipe_prospero_of_habsburg	john_of_austria_the_younger
<e> 's parent 's child	prince_feodor_alexandrovich_of_russia	prince_andrei_alexandrovich_of_russia
what is the <e> 's couple 's gender	maria_luisa_of_savoy	male
how <e> 's couple died	john_franklin	tuberculosis
what is the gender of parents of <e>	lady_louisa_stuart	male
what is the <e> 's kid 's gender	claudine_rhedey_von_kis_rhede	male
the nationality of darling of <e>	katherine_corri_harris	united_states
where does <e> 's dad work	george_darwin	christs_college_cambridge
<e> 's heir 's nationality	gustaf_vi_adolf_of_sweden	sweden
what is the darling of <e> 's child	sam_marx	susan_fleming
what is the gender of <e> 's parents	buster_keaton	male
the gender of <e> 's other half	grand_duchess_elizabeth_mikhailovna	male
what sex is <e> 's offspring	adelaide_of_lowenstein_wertheim_rosenberg	female
what is the ethnicity of <e> 's darling	george_tabori	swedish_american|swedish_people
where does <e> 's son work for	william_talbot	oriel_college
the work of kid of <e>	emperor_temmu	writer
where did <e> 's daughter die	anne_marie_martinozzi	fontainebleau
the gender of <e> 's couple	pearl_bailey	male
what is the sex of daughter of <e>	william_of_winchester_lord_of_lunenburg	male
what is the gender of couple of <e>	phillip_terry	female
what is the gender of other half of <e>	benjamin_harrison	female
what is the <e> 's other half 's sex	harry_hay	male
what is the <e> 's parent 's nation	john_i_of_denmark	germany
what type of religion does <e> 's dad have	j_p_morgan_jr	anglicanism
what is the sex of child of <e>	wang_khan	female
what is the <e> 's heir 's sex	marie_antoinette	female
what is the gender of father of <e>	mikolaj_vii_radziwill	female
what is the mom of parents of <e>	princess_amelia_sophia_of_great_britain	george_i_of_great_britain
the nationality of <e> 's other half	hermann_einstein	germany
what is the nation of mother of <e>	alexander_ii_of_russia	germany
<e> 's dad 's daughter	princess_sophia_dorothea_of_prussia	frederick_ii_of_prussia
what is the dad of children of <e>	charles_spurgeon	charles_spurgeon
what is the <e> 's mom 's heir	felipe_prospero_of_habsburg	john_of_austria_the_younger
what is the couple of <e> 's mom	sunandha	mongkut
what is the <e> 's parents 's place of death	princess_margaret_of_prussia	potsdam
what does <e> 's daughter do for a living	john_a_roebling	engineer
the sex of <e> 's children	aurangzeb	male
what is the nation of <e> 's son	princess_beatrice_of_the_united_kingdom	united_kingdom
what made the <e> 's coupledead	anahareo	pneumonia
who is the child of <e> 's son	duke_peter_of_oldenburg	grand_duke_peter_nicolaievich_of_russia|grand_duke_nicholas_nicolaevich_the_younger
the nation of <e> 's mother	princess_elizabeth_of_england	kingdom_of_france
<e> 's mom 's place of death	mihailo_obrenovic_iii_prince_of_serbia	belgrade
the gender of <e> 's darling	elizabeth_macquarie	male
what is the <e> 's daughter 's race	marvin_pentz_gay_sr	african_american
<e> 's mother 's heir	diego_colon	fernando_colon
what city did <e> 's offspring die	constantine_viii	constantinople
where did <e> 's father die	titus_van_rijn	amsterdam
<e> 's parents 's gender	alfonso_iv_of_leon	male
what is the <e> 's parent 's nationality	frederika_of_hanover	germany
what is the <e> 's daughter 's children	francis_iv_duke_of_modena	carlos_duke_of_madrid
who is the daughter of <e> 's kid	marguerite_of_france	elizabeth_of_rhuddlan
the gender of <e> 's couple	ruth_roland	male
the nation of spouse of <e>	bettye_ackerman	united_states
what line of business is <e> 's parents in	j_p_morgan_jr	financier
what gender is <e> 's child	barbu_stirbey	male
who is the kid of <e> 's father	charles_lennox_2nd_duke_of_richmond	charles_lennox_2nd_duke_of_richmond|anne_van_keppel_countess_of_albemarle
what is the dad of <e> 's mother	henry_i_duke_of_guise	renee_of_france
what faith does <e> 's heir have	jewna	paganism
how <e> 's father died	louise_juliana_of_nassau	assassination|firearm
what is the nationality of dad of <e>	lynn_redgrave	united_kingdom
what does <e> 's children do for a living	william_talbot	politician|lawyer
the organization of spouse of <e>	colleen_dewhurst	university_of_missouri_columbia
which nationality is <e> 's couple	frederica_of_mecklenburg-strelitz	united_kingdom
what is the name of the mother of <e> 's parents	christian_ii_of_denmark	dorothea_of_brandenburg
what does <e> 's children do	jawaharlal_nehru	politician
<e> 's daughter 's sex	qianlong_emperor	male
what is the nation of mom of <e>	henry_howard_7th_duke_of_norfolk	kingdom_of_england|england
is <e> 's children a man or a woman	michael_i_rangabe	male
which nationality is <e> 's children	william_backhouse_astor_jr	united_states
what is the kid of <e> 's father	princess_tenagnework	princess_tsehai
what is the <e> 's wife 's other half	henry_vii_of_england	henry_vii_of_england
what is the <e> 's mom 's gender	regina_crown_princess_of_austria	male
what is the educational institution of <e> 's child	benjamin_peirce	harvard_university
<e> 's father 's sex	frederick_v_of_denmark	female
what is the nationality of <e> 's mother	marie_francois_sadi_carnot	france
what is <e> 's spouse	richard_mulligan	actor
what killed the <e> 's couple	james_hepburn_4th_earl_of_bothwell	decapitation
where does <e> 's mother come from	alexander_ii_of_russia	germany
<e> 's parent 's cause of death	anna_e_roosevelt	tuberculosis
how <e> 's other half died	caesonia	tyrannicide
what is the place of birth of dad of <e>	rudolf_christian_count_of_ostfriesland	aurich
what made the <e> 's fatherdead	louise_juliana_of_nassau	assassination|firearm
what is the nation of mother of <e>	henry_howard_7th_duke_of_norfolk	kingdom_of_england|england
what religious belief does <e> 's mother practice	charles_ferdinand_duc_de_berry	catholicism
<e> 's parents 's educational institution	edward_salisbury_dana	yale_university
what is the gender of kid of <e>	sarah_lennox_duchess_of_richmond	male
what is the work of other half of <e>	doris_dowling	composer
the nation of mother of <e>	princess_elizabeth_of_england	kingdom_of_france
what is the father of wife of <e>	aelia_eudoxia	theodosius_i
what is the nationality of child of <e>	grand_duke_michael_mihailovich_of_russia	united_kingdom
who is the grandparent of <e>	william_kissam_vanderbilt	cornelius_vanderbilt
what is the <e> 's parents 's child	anne_of_cleves	sybille_of_cleves
what is the sex of <e> 's spouse	mary_stuart_countess_of_bute	male
what is the name of the child of <e> 's children	albert_of_saxe-coburg_and_gotha	victoria_eugenia_of_battenberg|prince_maurice_of_battenberg
the gender of child of <e>	henry_iii_holy_roman_emperor	male
what is the name of the parents of <e> 's mom	louis_philippe_i_duke_of_orleans	francoise_marie_de_bourbon
the mom of <e> 's daughter	osorkon_iii	osorkon_iii
what is the <e> 's parents 's sex	otto_i_duke_of_saxony	male
<e> 's parent 's daughter	takelot_iii	takelot_iii
what is the organization of mom of <e>	prince_joachim_of_prussia	university_of_bonn
the nation of son of <e>	johann_bernoulli	netherlands
what is the <e> 's parent 's nationality	robert_c_wickliffe	united_states
what is the <e> 's mom 's offspring	tasha_tudor	tasha_tudor
who is the heir of <e> 's children	wang_khan	mongke_khan
what is the <e> 's father 's gender	princess_tenagnework	male
is <e> 's dad a man or a woman	boleslaw_ii_of_poland	male
where did the parents of <e> die	louis_xvi_of_france	chateau_de_fontainebleau
where does <e> 's parent work for	tasha_tudor	harvard_university
the heir of <e> 's other half	henriette_adelaide_of_savoy	joseph_clemens_of_bavaria
<e> 's wife 's ethnicity	carlos_thompson	germans
<e> 's darling 's cause of death	mary_anna_custis_lee	pneumonia
which nationality is <e> 's son	pierre_curie	france
where is <e> 's mother staying	peter_van_pels	lower_saxony
what does <e> 's kid do for a living	john_hays_hammond	inventor
what faith does <e> 's child follow	george_of_saxony	roman_catholic_church
is <e> 's child a man or a woman	john_iv_of_portugal	male
<e> 's wife 's nationality	marie-anne_pierrette_paulze	united_kingdom|germany
the organization of <e> 's son	john_b_kelly_sr	american_academy_of_dramatic_arts
who is the offspring of <e> 's dad	clodoald	clodoald
what is the <e> 's darling 's nationality	katherine_corri_harris	united_states
what is the sex of <e> 's kid	chindasuinth	male
<e> 's couple 's gender	empress_xiaomu	male
the husband of <e> 's son	marie_of_edinburgh	archduke_anton_prince_of_tuscany
what is the gender of <e> 's darling	benjamin_disraeli_1st_earl_of_beaconsfield	female
what is the organization of <e> 's parent	john_f_kennedy_jr	riverdale_country_school|london_school_of_economics
the nation of offspring of <e>	john_spencer_churchill_7th_duke_of_marlborough	united_kingdom|england
the cause of death of mom of <e>	caligula	assassination
<e> 's husband 's sex	john_of_gaunt_1st_duke_of_lancaster	female
what is the faith of father of <e>	victor_amadeus_iii_of_sardinia	catholicism
what is the <e> 's couple 's sex	lew_cody	female
<e> 's wife 's gender	verina	male
what is the sex of dad of <e>	robert_i_duke_of_burgundy	male
what line of business is <e> 's heir in	henry_iv_of_england	monarch
where does <e> 's spouse work for	virginia_heinlein	united_states_naval_academy
<e> 's offspring 's cause of death	archduke_carl_ludwig_of_austria	firearm
where is <e> 's heir living	hermann_einstein	italy
what is the darling of <e> 's husband	robert_e_lee	robert_e_lee
what killed the <e> 's couple	madhubala	cardiovascular_disease
please tell me <e> 's children present address	augusta_viktoria_of_schleswig-holstein	potsdam
what is the race of father of <e>	princess_tenagnework	oromo
the darling of <e> 's child	sam_marx	susan_fleming
what is the <e> 's spouse 's gender	ptolemy_ix_lathyros	female
what is the other half of <e> 's other half	alexander_darcy	alexander_darcy
<e> 's husband 's gender	james_cruze	female
what is the nationality of darling of <e>	lew_cody	united_states
what is the <e> 's dad 's daughter	princess_sophia_dorothea_of_prussia	frederick_ii_of_prussia
what is the organization of father of <e>	lady_louisa_stuart	eton_college
what is the <e> 's other half 's type of religion	mariana_victoria_of_spain	catholicism
the gender of <e> 's parents	buster_keaton	male
what is the gender of <e> 's son	charles_ii_of_austria	female
is <e> 's parents a man or a woman	andrey_bolshoy	male
what is the <e> 's dad 's faith	john_ii_casimir_of_poland	catholicism
what is the <e> 's wife 's nation	vilhelmine_marie_of_denmark	denmark
the sex of darling of <e>	colleen_dewhurst	male
the religion of <e> 's wife	infante_fernando_duke_of_viseu	roman_catholic_church
what gender is <e> 's kid	marie_of_edinburgh	male
is <e> 's other half a man or a woman	anna_radziwill	male
the gender of children of <e>	princess_beatrice_of_the_united_kingdom	male
which city did <e> 's mother born	marguerite_of_france	leuven
<e> 's darling 's nation	margaret_mead	united_states
what is the <e> 's kid 's gender	alexandre_vicomte_de_beauharnais	female
what is the profession of <e> 's child	gheorghe_i_tasca	politician
what is the <e> 's parents 's gender	lady_louisa_stuart	male
what is the gender of <e> 's mother	pearl_starr	female
<e> 's parents 's daughter	infante_joao_of_portugal	infanta_isabel_duchess_of_burgundy
<e> 's wife 's profession	alexander_darcy	actor
the gender of <e> 's parent	princess_margaret_of_prussia	male
what is <e> 's spouse 's race like	elizabeth_de_burgh	scottish_people
the darling of <e> 's darling	arcadius	arcadius
who is the grandheir of <e>	jodhabai	shah_jahan
who is the child of <e> 's parent	shah_shuja	shah_shuja
which nationality is <e> 's darling	alva_belmont	united_states
what is the work of other half of <e>	elizabeth_of_york	monarch
what is the ethnicity of <e> 's couple	george_tabori	swedish_american|swedish_people
the nation of children of <e>	james_otis_sr	united_states
the place of death of offspring of <e>	maria_theresa_of_austria	vienna
what is the cause of death of <e> 's dad	isabella_of_france	animal_attack
is <e> 's parents a man or a woman	artabastos	male
what is the child of children of <e>	albert_of_saxe-coburg_and_gotha	victoria_eugenia_of_battenberg|prince_maurice_of_battenberg
what is the sex of <e> 's mother	henry_of_portugal	male
what is the <e> 's mother 's place of birth	marguerite_of_france	leuven
what is the mother of parents of <e>	christian_ii_of_denmark	dorothea_of_brandenburg
where does <e> 's darling come from	margaret_mead	united_states
<e> 's spouse 's place of birth	katherine_corri_harris	philadelphia
<e> 's kid 's couple	elena_pavlovna_of_wurttemberg	adolphe_grand_duke_of_luxembourg
the place of death of <e> 's mother	william_kissam_vanderbilt	new_york
the sex of child of <e>	jewna	male
who is the heir of <e> 's child	jodhabai	shah_jahan
what is the cause of death of mom of <e>	penelope_blount_countess_of_devonshire	dysentery
what did <e> 's dad die from	isabella_of_france	animal_attack
<e> 's heir 's gender	jahangir	male
why <e> 's mother died	skip_caray	cardiovascular_disease
how <e> 's kid died	john_d_rockefeller_jr	myocardial_infarction
the occupation of <e> 's heir	henry_iv_of_england	monarch
<e> 's husband 's organization	julie_london	wharton_school_of_the_university_of_pennsylvania
what is the sex of darling of <e>	ronald_reagan	female
where does <e> 's wife come from	robert_anderson_1917	united_states
the parents of <e> 's mom	lady_may_abel_smith	princess_helena_duchess_of_albany
what is the gender of kid of <e>	claudine_rhedey_von_kis_rhede	male
what is the sex of <e> 's father	eadgifu_of_england	male
what is the darling of children of <e>	james_ii_of_england	george_of_denmark
what is the sex of offspring of <e>	charles_lennox_1st_duke_of_richmond	male|female
the place of death of mom of <e>	william_ii_german_emperor	potsdam
the nationality of spouse of <e>	peter_sellers	england
<e> 's other half 's sex	harry_hay	male
what is the place of death of son of <e>	francis_i_of_france	paris
the nationality of <e> 's mom	george_formby	england
which nationality is <e> 's child	leonard_jerome	united_states
what is the son of husband of <e>	caroline_webster_schermerhorn_astor	john_jacob_astor_iv
the nation of offspring of <e>	grand_duchess_alexandra_petrovna	russia
what is the <e> 's mom 's organization	prince_joachim_of_prussia	university_of_bonn
what is the work of <e> 's children	j_presper_eckert	electrical_engineer
the other half of father of <e>	isabella_of_france	joan_i_of_navarre
what is the <e> 's wife 's cause of death	franz_joseph_i_of_austria	assassination
the gender of <e> 's other half	anne_of_bohemia	male
what is the name of the offspring of <e> 's mom	tasha_tudor	tasha_tudor
the nationality of kid of <e>	mary_de_bohun	england
what is the <e> 's darling 's wife	marjorie_merriweather_post	marjorie_merriweather_post
the child of <e> 's parents	anne_of_cleves	sybille_of_cleves
what is the name of the spouse of <e> 's husband	aelia_eudoxia	aelia_eudoxia
<e> 's parent 's offspring	lady_sarah_wilson	lord_randolph_churchill
the profession of husband of <e>	harry_hay	inventor
what is the place of death of <e> 's darling	elizabeth_allan_1908	new_york
what is the <e> 's parent 's sex	claudius	male
what gender is <e> 's heir	charles_i_of_england	female
<e> 's other half 's nationality	caroline_benn	united_kingdom
what is the religion of <e> 's wife	mary_josephine_hannon_fitzgerald	catholicism
what is the gender of darling of <e>	empress_xiaoquan_cheng	male
what ethnicity is <e> 's wife	noble_consort_wan	manchu
who is the parent of <e> 's son	augusta_of_saxe-weimar	william_i_german_emperor
what is the nationality of <e> 's son	pierre_curie	france
the gender of <e> 's darling	louise_juliana_of_nassau	male
what is the dad of <e> 's kid	chlodomer	chlodomer
the place of birth of <e> 's wife	alice_of_bourbon_parma	florence
the place of birth of <e> 's heir	jawaharlal_nehru	allahabad
what is the couple of <e> 's kid	alice_spencer	henry_hastings_5th_earl_of_huntingdon
the profession of <e> 's kid	sigurd_ibsen	film_director|screenwriter
<e> 's daughter 's heir	victoria_kinoiki_kekaulike	abigail_kapiolani_kawananakoa
what is the nation of <e> 's offspring	grand_duchess_alexandra_petrovna	russia
what is the sex of <e> 's dad	sviatoslav_ii_of_kiev	male
is <e> 's darling a man or a woman	samuel_gridley_howe	male|female
the nation of parent of <e>	john_i_of_denmark	germany
the location of parent of <e>	george_darwin	shrewsbury
the gender of couple of <e>	yaroslav_i_the_wise	male
what is the gender of <e> 's children	louis_ix_of_france	male
what gender is <e> 's parents	natalia_alexeievna_of_russia	female
the place of birth of <e> 's children	pierre_curie	paris
where does <e> 's wife come from	sybil_thomas_viscountess_rhondda	wales|united_kingdom
what gender is <e> 's kid	anton_philips	male
where does <e> 's son work	william_talbot	oriel_college
what is the <e> 's child 's sex	pierre_curie	female
what does <e> 's daughter do	alexandra_fyodorovna_of_hesse	grand_duchess
<e> 's father 's institution	thomas_lamb_eliot	harvard_divinity_school
<e> 's darling 's sex	albert_vii_archduke_of_austria	female
what is the <e> 's mom 's ethnicity	cleopatra_selene	greeks_in_egypt
<e> 's couple 's mother	victor_emmanuel_iii_of_italy	nicholas_i_of_montenegro
what is the gender of father of <e>	yixin_prince_gong	male
what did <e> 's mother die from	skip_caray	cardiovascular_disease
what is the job of <e> 's son	marvin_pentz_gay_sr	composer|record_producer
what is the <e> 's mom 's child	grand_duke_george_mikhailovich_of_russia	grand_duke_alexei_mikhailovich_of_russia
<e> 's children 's children	tiberius_nero	julius_caesar_drusus
what faith does <e> 's son have	christiane_eberhardine_of_brandenburg_bayreuth	catholicism
<e> 's dad 's sex	william_ii_german_emperor	male
the educational institution of dad of <e>	george_darwin	christs_college_cambridge
what is the parents of parents of <e>	princess_sophia_dorothea_of_prussia	sophia_dorothea_of_celle
what does <e> 's kid do for a living	hermann_einstein	physician
what gender is <e> 's parents	buster_keaton	male
what is the gender of dad of <e>	frederick_edward_guest	male
what sex is <e> 's other half	georg_donatus_hereditary_grand_duke_of_hesse	female
the couple of <e> 's couple	julie_london	julie_london
what is the name of the wife of <e> 's heir	maria_of_spain	infanta_isabella_clara_eugenia_of_spain
what line of business is <e> 's son in	nathan_mayer_rothschild	politician
how <e> 's couple died	anahareo	pneumonia
<e> 's child 's nationality	geza_i_of_hungary	hungary
what does <e> 's father do for a living	george_grossmith_jr	novelist|singer
what killed the <e> 's father	louise_juliana_of_nassau	assassination|firearm
what is the darling of husband of <e>	robert_e_lee	robert_e_lee
the nation of <e> 's couple	frederica_of_mecklenburg-strelitz	united_kingdom
what is the name of the mom of <e> 's daughter	osorkon_iii	osorkon_iii
the gender of <e> 's daughter	joseph_p_kennedy_sr	female
the place of birth of <e> 's mother	marguerite_of_france	leuven
<e> 's kid 's sex	christian_x_of_denmark	male
what faith does <e> 's father practice	victor_amadeus_iii_of_sardinia	catholicism
what is the <e> 's husband 's cause of death	evelyn_keyes	diabetes_mellitus
what is the nation of <e> 's couple	julie_london	united_states
what is the work of <e> 's kid	john_hays_hammond	inventor
the daughter of <e> 's child	archduke_carl_ludwig_of_austria	prince_ernst_von_hohenberg
what is <e> 's spouse	evelyn_keyes	composer
what is the organization of <e> 's spouse	colleen_dewhurst	university_of_missouri_columbia
the sex of child of <e>	pierre_curie	female
the place of death of <e> 's daughter	george_iii_of_the_united_kingdom	windsor_castle
what faith does <e> 's dad have	john_ii_casimir_of_poland	catholicism
the gender of darling of <e>	andronikos_iii_palaiologos	female
what is the <e> 's offspring 's place of death	maria_theresa_of_austria	vienna
<e> 's child 's sex	david_kawananakoa	female
what is the <e> 's child 's ethnicity	yongzheng_emperor	manchu
what is the nation of children of <e>	frank_lloyd_wright	united_states
is <e> 's dad a man or a woman	sviatoslav_ii_of_kiev	male
what is the <e> 's spouse 's parents	alva_belmont	william_henry_vanderbilt
what is the sex of mother of <e>	augustus_keppel_1st_viscount_keppel	male
what is the <e> 's husband 's profession	harry_hay	inventor
the gender of <e> 's spouse	carlos_thompson	female
what is the gender of <e> 's daughter	alice_betty_stern	male
the nation of <e> 's offspring	louis_duke_of_nemours	france
what is the gender of <e> 's kid	louis_xvi_of_france	female
<e> 's dad 's sex	constantine_xi	male
where does <e> 's other half come from	anahareo	canada|united_states
what is the heir of <e> 's daughter	christiane_eberhardine_of_brandenburg_bayreuth	marie_josephe_of_saxony
what is the <e> 's children 's gender	prince_alexander_of_hesse_and_by_rhine	male
<e> 's wife 's type of religion	james_hepburn_4th_earl_of_bothwell	catholicism
the place of birth of spouse of <e>	victor_emmanuel_iii_of_italy	cetinje
what is the husband of <e> 's son	marie_of_edinburgh	archduke_anton_prince_of_tuscany
is <e> 's darling a man or a woman	lovisa_of_sweden	male
<e> 's other half 's father	infanta_maria_de_la_paz_of_spain	infanta_amelia_philippina_of_spain
<e> 's parent 's religious belief	thomas_spurgeon	christian
<e> 's offspring 's son	chulalongkorn	nakkhatra_mangkala_kitiyakara
what is the place of death of son of <e>	maria_fyodorovna_of_russia	vienna
the educational institution of <e> 's parents	edward_salisbury_dana	yale_university
what is the address of heir of <e>	hermann_einstein	italy
what is the son of <e> 's kid	alexandre_vicomte_de_beauharnais	napoleon_iii_of_france
the gender of parent of <e>	princess_margaret_of_prussia	male
what type of religion is <e> 's other half	mariana_victoria_of_spain	catholicism
<e> 's kid 's gender	henrietta_anne_stuart	female
why <e> 's couple died	john_franklin	tuberculosis
what is the gender of <e> 's husband	cecilia_renata_of_austria	male
what is the gender of <e> 's couple	yaroslav_i_the_wise	male
where does <e> 's father work	thomas_lamb_eliot	harvard_divinity_school
what city did <e> 's offspring die	archduchess_maria_beatrix_of_austria_este	varese
what sex is <e> 's heir	mutemwiya_wife_of_thutmose_iv	male
who is the son of <e> 's offspring	chulalongkorn	nakkhatra_mangkala_kitiyakara
what is the gender of darling of <e>	louise_juliana_of_nassau	male
the nation of <e> 's daughter	roy_thomson_1st_baron_thomson_of_fleet	canada
the wife of <e> 's dad	henry_ii_of_england	henry_v_holy_roman_emperor
what is the <e> 's spouse 's daughter	noble_consort_wan	jiaqing_emperor
what is the nation of daughter of <e>	nathan_mayer_rothschild	united_kingdom
where did the father of <e> die	roy_e_disney	burbank
what killed the <e> 's father	george_darwin	coronary_thrombosis
what gender is <e> 's darling	andronikos_iii_palaiologos	female
<e> 's kid 's nation	louise_of_mecklenburg-strelitz	germany
the son of father of <e>	charles_duke_of_lower_lorraine	lothair_of_france
what is the <e> 's son 's mother	grand_duke_konstantin_nikolayevich_of_russia	alexandra_iosifovna_of_altenburg
what does <e> 's father do	george_grossmith_jr	novelist|singer
the ethnicity of <e> 's wife	carlos_thompson	germans
what is <e> 's parent working on	ethel_lilian_voynich	mathematician
what is the <e> 's dad 's kid	henry_iv_holy_roman_emperor	henry_iv_holy_roman_emperor
the parents of spouse of <e>	juliana_maria_of_brunswick_wolfenbuttel	sophia_magdalen_of_brandenburg-kulmbach
what is the nation of <e> 's wife	robert_anderson_1917	united_states
where does <e> 's parent come from	frederika_of_hanover	germany
is <e> 's daughter a man or a woman	alice_betty_stern	male
what killed the <e> 's darling	ida_lupino	lung_cancer
what is the cause of death of <e> 's darling	mary_anna_custis_lee	pneumonia
what is the <e> 's dad 's sex	robert_i_duke_of_burgundy	male
what is the name of the heir of <e> 's mother	charles_lennox_2nd_duke_of_richmond	charles_lennox_2nd_duke_of_richmond|anne_van_keppel_countess_of_albemarle
which nationality is <e> 's parents	lady_louisa_stuart	scotland
where does <e> 's offspring come from	henry_of_scotland_3rd_earl_of_huntingdon	kingdom_of_scotland
the heir of <e> 's mother	marguerite_of_france	louis_devreux
what is the <e> 's daughter 's nation	roy_thomson_1st_baron_thomson_of_fleet	canada
what is the <e> 's heir 's ethnicity	alice_betty_stern	germans
what is the <e> 's kid 's gender	sarah_lennox_duchess_of_richmond	male
where did the daughter of <e> die	henry_stanton	greenwich_connecticut
the place of death of <e> 's child	cheryl_crowe	escondido
what is the <e> 's kid 's work	blessed_virgin_mary	carpenter
is <e> 's offspring a man or a woman	gustavus_adolphus_of_sweden	female
what is the faith of <e> 's dad	john_ii_casimir_of_poland	catholicism
who is the heir of <e> 's mother	charles_lennox_2nd_duke_of_richmond	charles_lennox_2nd_duke_of_richmond|anne_van_keppel_countess_of_albemarle
what is the sex of parents of <e>	ludwig_ii_of_bavaria	male
is <e> 's husband a man or a woman	grand_duke_peter_nicolaievich_of_russia	female
the nationality of mom of <e>	diego_colon	italy
what is the father of <e> 's child	yongzheng_emperor	yongzheng_emperor
the cause of death of daughter of <e>	james_otis_sr	lightning
who is the mother of <e> 's parents	marguerite_of_france	henry_iii_duke_of_brabant
what is the father of <e> 's kid	charles_a_wickliffe	charles_a_wickliffe
what is the <e> 's children 's gender	louis_ix_of_france	male
<e> 's parents 's nationality	claudius	roman_empire
the sex of heir of <e>	sylvia_likens	male
is <e> 's darling a man or a woman	joseph_e_davies	female
the sex of child of <e>	svante_nilsson	male
the heir of <e> 's mother	diego_colon	fernando_colon
the son of parent of <e>	robert_c_wickliffe	robert_c_wickliffe
the cause of death of <e> 's son	marvin_pentz_gay_sr	firearm
what is the mom of <e> 's daughter	osorkon_iii	osorkon_iii
<e> 's offspring 's faith	hermann_einstein	jew
what is the <e> 's child 's daughter	archduke_carl_ludwig_of_austria	prince_ernst_von_hohenberg
the race of parent of <e>	simeon_uro	serbs
what city did <e> 's darling die	anna_lee	santa_barbara
who is the darling of <e> 's other half	joseph_e_davies	joseph_e_davies
what is the cause of death of heir of <e>	pedro_ii_of_brazil	yellow_fever
what is the job of <e> 's kid	hermann_einstein	physician
what is the name of the darling of <e> 's other half	joseph_e_davies	joseph_e_davies
the son of father of <e>	maria_antonia_of_portugal	maria_josepha_of_portugal
the educational institution of parents of <e>	edward_salisbury_dana	yale_university
<e> 's kid 's nationality	mary_de_bohun	england
what is the nation of wife of <e>	anahareo	canada|united_states
what is the nation of <e> 's parent	pearl_starr	united_states
what is the son of <e> 's parents	niels_bohr	harald_bohr
which organization does <e> 's parent work for	john_f_kennedy_jr	riverdale_country_school|london_school_of_economics
what is the cause of death of other half of <e>	adolf_hitler	suicide|cyanide_poisoning
where does <e> 's darling come from	katherine_corri_harris	united_states
where does <e> 's child work	benjamin_peirce	harvard_university
what is the son of <e> 's kid	leopold_grand_duke_of_baden	grand_duke_alexei_mikhailovich_of_russia
what is the sex of spouse of <e>	mary_stuart_countess_of_bute	male
who is the daughter of <e> 's parent	elisabeth_of_austria_1526	maria_of_habsburg_archduchess_of_austria
what is the gender of child of <e>	grand_duke_michael_mihailovich_of_russia	female
what sex is <e> 's dad	william_ii_german_emperor	male
<e> 's couple 's sex	chilperic_i	female
the gender of child of <e>	barbu_stirbey	male
what gender is <e> 's husband	james_cruze	female
what is the gender of <e> 's darling	richard_mulligan	female
the sex of <e> 's wife	laura_borden	male
what is the sex of <e> 's child	p_j_kennedy	male
where does <e> 's parent come from	pearl_starr	united_states
what is the gender of parents of <e>	lord_robert_manners	male
the sex of child of <e>	david_kawananakoa	female
is <e> 's wife a man or a woman	princess_ileana_of_romania	male
<e> 's offspring 's place of death	archduchess_maria_beatrix_of_austria_este	varese
what is the nationality of dad of <e>	niels_bohr	denmark
the gender of <e> 's mom	thomas_lamb_eliot	male
<e> 's darling 's gender	franz_joseph_i_of_austria	female
where is <e> 's mother living	peter_van_pels	lower_saxony
what is the name of the child of <e> 's child	albert_of_saxe-coburg_and_gotha	victoria_eugenia_of_battenberg|prince_maurice_of_battenberg
what is the organization of <e> 's father	lady_louisa_stuart	eton_college
what is the <e> 's mother 's dad	henry_i_duke_of_guise	renee_of_france
what sex is <e> 's father	eadgifu_of_england	male
what is <e> 's husband working on	ronald_reagan	actor
what is <e> 's child 's ethnicity about	major_ridge	cherokee|native_americans_in_the_united_states
the sex of darling of <e>	ronald_reagan	female
what is the <e> 's mom 's parents	lady_may_abel_smith	princess_helena_duchess_of_albany
the nationality of son of <e>	isabella_of_castile	spain
what is the <e> 's offspring 's sex	leonard_jerome	female
the sex of <e> 's husband	john_of_gaunt_1st_duke_of_lancaster	female
the gender of <e> 's child	john_iv_of_portugal	male
<e> 's spouse 's parents	alva_belmont	william_henry_vanderbilt
what killed the <e> 's mother	skip_caray	cardiovascular_disease
what is the nation of offspring of <e>	louis_duke_of_nemours	france
what is the sex of <e> 's dad	princess_elizabeth_of_england	female
what is the nation of <e> 's son	johann_bernoulli	netherlands
what is the name of the grandson of <e>	alexandre_vicomte_de_beauharnais	napoleon_iii_of_france
who is the heir of <e> 's other half	henriette_adelaide_of_savoy	joseph_clemens_of_bavaria
the place of birth of <e> 's dad	rudolf_christian_count_of_ostfriesland	aurich
the gender of daughter of <e>	hortense_de_beauharnais	male
what is the mom of <e> 's father	princess_caroline_elizabeth_of_great_britain	george_i_of_great_britain
what is the <e> 's father 's darling	henry_viii_of_england	elizabeth_of_york
the offspring of offspring of <e>	grand_duchess_alexandra_petrovna	princess_nadejda_petrovna_of_russia
the gender of child of <e>	augusta_viktoria_of_schleswig-holstein	male
<e> 's couple 's nationality	anne_of_great_britain	denmark
where does <e> 's children work	roy_thomson_1st_baron_thomson_of_fleet	upper_canada_college
what is the <e> 's father 's cause of death	george_darwin	coronary_thrombosis
what is the <e> 's son 's mother	william_starling_burgess	william_starling_burgess
what is the nation of <e> 's offspring	henry_of_scotland_3rd_earl_of_huntingdon	kingdom_of_scotland
<e> 's father 's location	kikkawa_motoharu	aki_province
which educational institution does <e> 's darling work for	effie_gray	christ_church_oxford
what does <e> 's parents do for a living	buster_keaton	actor
is <e> 's husband a man or a woman	cecilia_renata_of_austria	male
<e> 's children 's sex	aurangzeb	male
the heir of <e> 's daughter	victoria_kinoiki_kekaulike	abigail_kapiolani_kawananakoa
what is the <e> 's child 's parents	anton_philips	anton_philips
the place of birth of child of <e>	archduke_carl_ludwig_of_austria	graz
what is the <e> 's parents 's children	ulysses_s_grant_jr	frederick_dent_grant
what is the nation of mother of <e>	princess_elizabeth_of_england	kingdom_of_france
what is the <e> 's father 's parents	henry_iii_of_france	madeleine_de_la_tour_dauvergne
the nation of child of <e>	svante_nilsson	sweden
<e> 's children 's dad	charles_i_of_england	henrietta_maria_of_france
what sex is <e> 's darling	audrey_hepburn	male
what is the race of darling of <e>	margaret_sullavan	jew
what is the father of daughter of <e>	louis_iv_of_france	gerberga_of_saxony
is <e> 's husband a man or a woman	james_cruze	female
who is the other half of <e> 's wife	henry_vii_of_england	henry_vii_of_england
what is the parent of couple of <e>	noble_consort_wan	yongzheng_emperor
what is the <e> 's child 's gender	john_v_palaiologos	male
<e> 's wife 's nation	vilhelmine_marie_of_denmark	denmark
what is the job of <e> 's kid	james_henry_hackett	actor
where does <e> 's mom come from	henry_howard_7th_duke_of_norfolk	kingdom_of_england|england
is <e> 's spouse a man or a woman	ptolemy_ix_lathyros	female
<e> 's dad 's nation	frank_reicher	germany
is <e> 's mother a man or a woman	pearl_starr	female
the cause of death of <e> 's mom	princess_tenagnework	allegedly_murdered
what is the ethnicity of wife of <e>	carlos_thompson	germans
the sex of other half of <e>	harry_hay	male
<e> 's husband 's nation	phillip_terry	france
which institution does <e> 's dad work for	edward_smith_stanley_14th_earl_of_derby	trinity_college_cambridge
<e> 's offspring 's sex	maria_of_spain	male
what is the name of the child of <e> 's parent	thomas_spurgeon	thomas_spurgeon
the cause of death of <e> 's father	alexander_kara_or_evic_prince_of_serbia	assassination
<e> 's dad 's nationality	niels_bohr	denmark
what is the place of birth of mom of <e>	anna_e_roosevelt	new_york
what is the father of <e> 's daughter	louis_iv_of_france	gerberga_of_saxony
what religion does <e> 's spouse practice	edwin_samuel_montagu	judaism
the race of <e> 's darling	margaret_sullavan	jew
what is the <e> 's heir 's nationality	gustaf_vi_adolf_of_sweden	sweden
who is the children of <e> 's daughter	p_j_kennedy	rosemary_kennedy
what is the work of father of <e>	george_grossmith_jr	novelist|singer
what is the <e> 's mother 's gender	charlotte_duchess_of_albany	male
what is the name of the grandparent of <e>	william_kissam_vanderbilt	cornelius_vanderbilt
what is the place of birth of <e> 's mom	adolphus_busch_iii	st_louis_missouri
what gender is <e> 's other half	grand_duchess_elizabeth_mikhailovna	male
<e> 's wife 's parents	juba_ii	cleopatra_vii_of_egypt
what does <e> 's parent do	princess_tenagnework	monarch
the sex of kid of <e>	christian_x_of_denmark	male
where does <e> 's parent come from	george_herbert_11th_earl_of_pembroke	united_kingdom
what is the <e> 's parents 's gender	andrey_bolshoy	male
<e> 's couple 's gender	ruth_roland	male
what is <e> 's daughter	william_talbot	politician|lawyer
who is the son of <e> 's parents	niels_bohr	harald_bohr
<e> 's dad 's nation	henry_ii_of_england	kingdom_of_england
what is the <e> 's other half 's gender	anne_of_bohemia	male
what is the sex of husband of <e>	grand_duke_peter_nicolaievich_of_russia	female
what is <e> 's other half working on	ekaterina_svanidze	generalissimo
what killed the <e> 's mom	princess_tenagnework	allegedly_murdered
what is the <e> 's father 's occupation	edith_craig	architect
what is the job of <e> 's darling	elizabeth_blair_lee	naval_officer
what is the work of kid of <e>	cosima_wagner	conducting|composer
what is the gender of <e> 's parents	alfonso_iv_of_leon	male
what is the <e> 's son 's nation	johann_bernoulli	netherlands
<e> 's parents 's parents	princess_sophia_dorothea_of_prussia	sophia_dorothea_of_celle
what is the sex of wife of <e>	laura_borden	male
what is the educational institution of spouse of <e>	virginia_heinlein	united_states_naval_academy
the sex of dad of <e>	sviatoslav_ii_of_kiev	male
the gender of <e> 's couple	maria_luisa_of_savoy	male
who is the children of <e> 's children	tiberius_nero	julius_caesar_drusus
what is the sex of offspring of <e>	adelaide_of_lowenstein_wertheim_rosenberg	female
what is the nation of <e> 's child	svante_nilsson	sweden
what is the child of parents of <e>	anne_of_cleves	sybille_of_cleves
the religious belief of other half of <e>	rani_mangammal	hinduism
the sex of husband of <e>	claudius	female
what religion does <e> 's wife have	infante_fernando_duke_of_viseu	roman_catholic_church
what is the <e> 's wife 's profession	alexander_darcy	actor
what is the nation of parent of <e>	ramon_berenguer_i_count_of_barcelona	spain
what gender is <e> 's father	yixin_prince_gong	male
where is <e> 's daughter living	casimir_iv_jagiellon	krakow
what is the <e> 's father 's job	elisabeth_of_austria_1526	holy_roman_emperor
what is the gender of kid of <e>	alexandre_vicomte_de_beauharnais	female
<e> 's offspring 's gender	artavasdes_i_of_armenia	male
what sex is <e> 's other half	juba_ii	female
<e> 's other half 's gender	samuel_gridley_howe	male|female
what is the nationality of parents of <e>	claudius	roman_empire
what is the occupation of offspring of <e>	frances_polidori	illustrator
the sex of <e> 's mother	augustus_keppel_1st_viscount_keppel	male
the son of <e> 's father	charles_duke_of_lower_lorraine	lothair_of_france
what type of religion does <e> 's dad practice	j_p_morgan_jr	anglicanism
what line of business is <e> 's parent in	ethel_lilian_voynich	mathematician
the daughter of parent of <e>	elisabeth_of_austria_1526	maria_of_habsburg_archduchess_of_austria
what is the religious belief of <e> 's father	george_darwin	anglicanism|agnosticism
what is the <e> 's couple 's address	robert_lowell	london
<e> 's spouse 's job	richard_mulligan	actor
the job of spouse of <e>	doris_blackburn	lawyer
<e> 's darling 's wife	elizabeth_of_york	elizabeth_of_york
the place of death of <e> 's darling	anahareo	prince_albert
what is the nation of husband of <e>	mae_west	united_states
what is the type of religion of <e> 's couple	sarah	judaism
the wife of heir of <e>	maria_of_spain	infanta_isabella_clara_eugenia_of_spain
what is the name of the parents of <e> 's daughter	thomas_thynne_2nd_viscount_weymouth	thomas_thynne_2nd_viscount_weymouth
<e> 's wife 's nationality	sybil_thomas_viscountess_rhondda	wales|united_kingdom
what is the sex of darling of <e>	audrey_hepburn	male
where does <e> 's parents come from	edward_salisbury_dana	united_states
what is the <e> 's dad 's gender	boleslaw_ii_of_poland	male
what is the organization of <e> 's dad	john_f_kennedy_jr	riverdale_country_school|london_school_of_economics
what is the gender of mother of <e>	philip_ii_of_taranto	male
the place of death of mother of <e>	william_kissam_vanderbilt	new_york
is <e> 's mother a man or a woman	charlotte_duchess_of_albany	male
the cause of death of dad of <e>	louise_juliana_of_nassau	assassination|firearm
what is the hometown of <e> 's children	archduchess_maria_beatrix_of_austria_este	ljubljana
the sex of <e> 's kid	grand_duke_alexander_mikhailovich_of_russia	male
what is the nation of <e> 's son	maria_luisa_of_parma	spain
what is the <e> 's parents 's sex	vasili_i_of_russia	female
<e> 's mom 's gender	catharina_of_sweden	male
the child of <e> 's mom	gaston_comte_deu	gaston_comte_deu
how <e> 's spouse died	adolf_hitler	suicide|cyanide_poisoning
the gender of daughter of <e>	erekle_i_of_kakheti	male
the gender of dad of <e>	boleslaw_ii_of_poland	male
the sex of wife of <e>	james_hepburn_4th_earl_of_bothwell	female
what is the nation of <e> 's husband	sybil_thomas_viscountess_rhondda	wales|united_kingdom
who is the granddad of <e>	prince_joachim_of_prussia	frederick_iii_german_emperor
what is the <e> 's other half 's nation	marie-anne_pierrette_paulze	united_kingdom|germany
what is the children of daughter of <e>	francis_iv_duke_of_modena	carlos_duke_of_madrid
what gender is <e> 's other half	benjamin_harrison	female
what is the place of death of <e> 's husband	audrey_hepburn	santa_barbara
the other half of wife of <e>	henry_vii_of_england	henry_vii_of_england
what is the religious belief of husband of <e>	samuel_gridley_howe	unitarian_universalism
the father of <e> 's children	henry_iii_holy_roman_emperor	henry_iii_holy_roman_emperor
what is the name of the spouse of <e> 's mom	henry_i_duke_of_guise	jacques_de_savoie_2nd_duc_de_nemours
the educational institution of other half of <e>	caroline_webster_schermerhorn_astor	columbia_university
is <e> 's mother a man or a woman	niels_bohr	male
the sex of parent of <e>	louis_philippe_i_duke_of_orleans	male
what is the <e> 's couple 's educational institution	mary_stuart_countess_of_bute	eton_college
what is the <e> 's spouse 's job	evelyn_keyes	composer
the gender of <e> 's mom	regina_crown_princess_of_austria	male
what did <e> 's children die from	srinagarindra	firearm
the sex of <e> 's parent	prince_louis_ferdinand_of_bavaria	female
what is <e> 's couple 's ethnicity about	george_tabori	swedish_american|swedish_people
the gender of <e> 's daughter	hortense_de_beauharnais	male
the sex of other half of <e>	georg_donatus_hereditary_grand_duke_of_hesse	female
what is the husband of <e> 's mother	robert_i_duke_of_burgundy	constance_of_arles
<e> 's kid 's job	thomas_thynne_2nd_viscount_weymouth	politician
what is the ethnicity of heir of <e>	alice_betty_stern	germans
the occupation of <e> 's husband	ronald_reagan	actor
what is the race of <e> 's offspring	artavasdes_i_of_armenia	armenians
what is <e> 's other half working on	luis_munoz_marin	first_lady
what faith does <e> 's child have	george_of_saxony	roman_catholic_church
the institution of <e> 's kid	anton_philips	delft_university_of_technology
what does <e> 's husband do	roger_needham	computer_scientist
what is the nationality of other half of <e>	edward_blake	canada
the gender of <e> 's couple	kira_kirillovna_of_russia	male
what is <e> 's father	henry_viii_of_england	monarch
who is the offspring of <e> 's mom	tasha_tudor	tasha_tudor
what is the <e> 's spouse 's nation	margaret_sullavan	france
the heir of parent of <e>	catherine_of_braganza	teodosio_prince_of_brazil
the faith of husband of <e>	marie-anne_pierrette_paulze	anglicanism
the work of kid of <e>	blessed_virgin_mary	carpenter
which organization does <e> 's son work for	john_b_kelly_sr	american_academy_of_dramatic_arts
<e> 's child 's father	yongzheng_emperor	yongzheng_emperor
what is the mother of <e> 's wife	caesonia	germanicus
where does <e> 's son come from	isabella_of_castile	spain
where does <e> 's couple work for	mary_stuart_countess_of_bute	eton_college
the nationality of <e> 's child	john_d_rockefeller_jr	united_states
is <e> 's husband a man or a woman	samuel_pepys	female
what is the nation of <e> 's other half	anahareo	canada|united_states
what religious belief does <e> 's parents practice	mihrimar	islam
what gender is <e> 's mom	regina_crown_princess_of_austria	male
what is the son of parent of <e>	archduke_louis_of_austria	rudolf_cardinal_von_habsburg_lothringen|archduke_joseph_of_austria_palatine_of_hungary
what is the nationality of <e> 's daughter	john_spencer_churchill_7th_duke_of_marlborough	united_kingdom|england
which city did <e> 's wife born	adolf_hitler	munich
<e> 's mother 's sex	false_dmitriy_i	male
who is the children of <e> 's mother	henry_i_duke_of_guise	charles_of_lorraine_duke_of_mayenne
what is the race of <e> 's spouse	elizabeth_de_burgh	scottish_people
what does <e> 's children do for a living	princess_margaret_of_connaught	prince
<e> 's other half 's nationality	princess_sibylla_of_saxe-coburg_and_gotha	sweden
the nation of <e> 's spouse	luz_magsaysay	philippines
the sex of offspring of <e>	adelaide_of_lowenstein_wertheim_rosenberg	female
what is the sex of <e> 's daughter	qianlong_emperor	male
<e> 's child 's nation	svante_nilsson	sweden
<e> 's daughter 's gender	hortense_de_beauharnais	male
the gender of <e> 's darling	franz_joseph_i_of_austria	female
where did the darling of <e> die	anna_lee	santa_barbara
why <e> 's spouse died	adolf_hitler	suicide|cyanide_poisoning
what is <e> 's kid working on	john_hays_hammond	inventor
what is the nation of <e> 's parent	david_carradine	united_states
what is the place of death of <e> 's father	roy_e_disney	burbank
the gender of <e> 's other half	samuel_gridley_howe	male|female
<e> 's offspring 's nation	john_spencer_churchill_7th_duke_of_marlborough	united_kingdom|england
where does <e> 's mother come from	marie_francois_sadi_carnot	france
the nationality of <e> 's other half	princess_sibylla_of_saxe-coburg_and_gotha	sweden
what is the <e> 's husband 's gender	martha_bulloch	male
what is <e> 's daughter working on	alexandra_fyodorovna_of_hesse	grand_duchess
the nation of <e> 's darling	alva_belmont	united_states
is <e> 's darling a man or a woman	elizabeth_macquarie	male
which institution does <e> 's children work for	roy_thomson_1st_baron_thomson_of_fleet	upper_canada_college
<e> 's parent 's sex	penelope_blount_countess_of_devonshire	male
what is the nation of <e> 's husband	mary_stuart_countess_of_bute	scotland
what is the <e> 's dad 's cause of death	justinus_van_nassau	assassination|firearm
the gender of <e> 's child	augusta_viktoria_of_schleswig-holstein	male
the nationality of <e> 's wife	sybil_thomas_viscountess_rhondda	wales|united_kingdom
the nation of mom of <e>	lady_sarah_wilson	united_kingdom
<e> 's other half 's sex	georg_donatus_hereditary_grand_duke_of_hesse	female
is <e> 's wife a man or a woman	verina	male
what sex is <e> 's parent	prince_louis_ferdinand_of_bavaria	female
what is the <e> 's father 's place of death	titus_van_rijn	amsterdam
what city did <e> 's son die	maria_fyodorovna_of_russia	vienna
what line of business is <e> 's dad in	louis_the_pious	emperor
the other half of <e> 's father	isabella_of_france	joan_i_of_navarre
the gender of <e> 's couple	ekaterina_svanidze	male
what is the offspring of dad of <e>	clodoald	clodoald
<e> 's son 's nation	maria_luisa_of_parma	spain
what is the gender of <e> 's couple	empress_xiaomu	male
is <e> 's couple a man or a woman	ruth_roland	male
<e> 's husband 's nation	sybil_thomas_viscountess_rhondda	wales|united_kingdom
what is the nationality of <e> 's parent	frederika_of_hanover	germany
what is the sex of <e> 's spouse	jeanne_ii_countess_of_burgundy	male
what is the name of the son of <e> 's parent	princess_margaret_of_prussia	princess_charlotte_of_prussia
what is the name of the son of <e> 's husband	caroline_webster_schermerhorn_astor	john_jacob_astor_iv
what is the <e> 's dad 's gender	henry_cromwell	female
what is the father of <e> 's daughter	ellen_terry	edward_william_godwin
what sex is <e> 's darling	colleen_dewhurst	male
what is the husband of heir of <e>	philip_v_of_spain	joseph_i_of_portugal
what is the cause of death of husband of <e>	doris_dowling	diabetes_mellitus
the job of son of <e>	john_b_kelly_sr	fashion_model
the sex of <e> 's darling	kalama	male
what type of religion does <e> 's mom practice	domenico_tintoretto	catholicism
what is the heir of child of <e>	jodhabai	shah_jahan
what type of religion is <e> 's couple	sarah	judaism
where did <e> 's husband die	kalama	honolulu
what is <e> 's kid working on	emperor_temmu	writer
<e> 's husband 's religious belief	samuel_gridley_howe	unitarian_universalism
what is the <e> 's parent 's nation	pearl_starr	united_states
what is the name of the granddaughter of <e>	duke_peter_of_oldenburg	grand_duke_peter_nicolaievich_of_russia|grand_duke_nicholas_nicolaevich_the_younger
is <e> 's darling a man or a woman	elizabeth_allan_1908	male
what is the <e> 's mother 's religious belief	charles_ferdinand_duc_de_berry	catholicism
who is the grandchild of <e>	albert_of_saxe-coburg_and_gotha	victoria_eugenia_of_battenberg|prince_maurice_of_battenberg
the gender of <e> 's darling	empress_xiaoquan_cheng	male
the heir of daughter of <e>	victoria_kinoiki_kekaulike	abigail_kapiolani_kawananakoa
the nationality of <e> 's dad	titus_van_rijn	netherlands
what made the <e> 's momdead	princess_tenagnework	allegedly_murdered
what type of religion is <e> 's heir	alice_betty_stern	jew
what is the name of the wife of <e> 's darling	marjorie_merriweather_post	marjorie_merriweather_post
what is the hometown of <e> 's child	archduke_carl_ludwig_of_austria	graz
what is the <e> 's offspring 's nation	henry_of_scotland_3rd_earl_of_huntingdon	kingdom_of_scotland
what is the <e> 's darling 's gender	benjamin_disraeli_1st_earl_of_beaconsfield	female
what is the name of the father of <e> 's daughter	ellen_terry	edward_william_godwin
what is the sex of <e> 's mother	augustus_keppel_1st_viscount_keppel	male
the sex of <e> 's husband	claudius	female
the sex of husband of <e>	john_of_gaunt_1st_duke_of_lancaster	female
what sex is <e> 's child	svante_nilsson	male
<e> 's parents 's sex	tyrone_power	male
what caused the <e> 's father 's death	alexander_kara_or_evic_prince_of_serbia	assassination
<e> 's husband 's nation	mae_west	united_states
what is the son of <e> 's parent	robert_c_wickliffe	robert_c_wickliffe
the address of parents of <e>	skip_caray	st_louis_missouri
is <e> 's husband a man or a woman	claudius	female
the nationality of <e> 's mother	marie_francois_sadi_carnot	france
how <e> 's mom died	caligula	assassination
who is the father of <e> 's wife	aelia_eudoxia	theodosius_i
what is the gender of <e> 's spouse	helena_of_moscow	male
<e> 's wife 's ethnicity	noble_consort_wan	manchu
the educational institution of <e> 's couple	mary_stuart_countess_of_bute	eton_college
<e> 's kid 's gender	marie_of_edinburgh	male
the nationality of <e> 's child	charles_a_wickliffe	united_states
what is the <e> 's darling 's sex	albert_vii_archduke_of_austria	female
<e> 's father 's nation	catherine_carey	kingdom_of_england
the place of death of <e> 's offspring	augustus_ii_the_strong	avignon
what type of religion does <e> 's daughter have	franz_josef_i_prince_of_liechtenstein	catholicism
the sex of <e> 's offspring	hermann_einstein	female
is <e> 's kid a man or a woman	anton_philips	male
which nationality is <e> 's son	grand_duke_konstantin_nikolayevich_of_russia	russia
what is the <e> 's wife 's work	ernest_hemingway	journalist
what is the nation of <e> 's husband	mae_west	united_states
what is the nation of <e> 's spouse	luz_magsaysay	philippines
the place of death of <e> 's husband	audrey_hepburn	santa_barbara
<e> 's parents 's place of death	louis_xvi_of_france	chateau_de_fontainebleau
the son of mom of <e>	john_ii_casimir_of_poland	alexander_charles_vasa
where does <e> 's kid come from	hortense_de_beauharnais	france
what is the couple of <e> 's kid	elena_pavlovna_of_wurttemberg	adolphe_grand_duke_of_luxembourg
what sex is <e> 's parents	vasili_i_of_russia	female
what is the <e> 's daughter 's heir	christiane_eberhardine_of_brandenburg_bayreuth	marie_josephe_of_saxony
what is the wife of couple of <e>	bobby_troup	bobby_troup
what is the kid of father of <e>	charles_lennox_2nd_duke_of_richmond	charles_lennox_2nd_duke_of_richmond|anne_van_keppel_countess_of_albemarle
what is the name of the daughter of <e> 's parent	louis_of_bourbon_duke_of_orleans	duc_dorleans
what is the sex of darling of <e>	samuel_gridley_howe	male|female
the organization of <e> 's father	james_a_bayard_jr	princeton_university
<e> 's dad 's kid	henry_iv_holy_roman_emperor	henry_iv_holy_roman_emperor
<e> 's husband 's sex	matilda_of_flanders	male
where does <e> 's husband work for	julie_london	wharton_school_of_the_university_of_pennsylvania
what is the gender of <e> 's mother	anne_of_cleves	male
which nationality is <e> 's spouse	peter_sellers	england
what is the <e> 's mother 's sex	techichpotzin	male
where did the kid of <e> die	princess_beatrice_of_the_united_kingdom	lausanne
the daughter of <e> 's parent	takelot_iii	takelot_iii
what is the nation of <e> 's husband	phillip_terry	france
what is the <e> 's child 's dad	gustavus_adolphus_of_sweden	maria_eleonora_of_brandenburg
what is the <e> 's offspring 's kid	yongzheng_emperor	jiaqing_emperor
the place of death of <e> 's heir	francis_iv_duke_of_modena	graz
what religion is <e> 's wife	infante_fernando_duke_of_viseu	roman_catholic_church
<e> 's child 's gender	grand_duke_michael_mihailovich_of_russia	female
is <e> 's wife a man or a woman	huey_long	female
<e> 's kid 's daughter	marguerite_of_france	elizabeth_of_rhuddlan
what is the <e> 's parent 's daughter	louis_of_bourbon_duke_of_orleans	duc_dorleans
what is the name of the parents of <e> 's spouse	alva_belmont	william_henry_vanderbilt
the gender of <e> 's child	barbu_stirbey	male
what is the <e> 's other half 's gender	talitha_getty	male
what is <e> 's child	gheorghe_i_tasca	politician
what is the <e> 's heir 's sex	mutemwiya_wife_of_thutmose_iv	male
what is the <e> 's offspring 's offspring	grand_duchess_alexandra_petrovna	princess_nadejda_petrovna_of_russia
what is the <e> 's darling 's sex	audrey_hepburn	male
what is the type of religion of couple of <e>	sarah	judaism
<e> 's heir 's sex	mutemwiya_wife_of_thutmose_iv	male
what is the gender of <e> 's couple	gaius_marius	male
what is the <e> 's children 's darling	james_ii_of_england	george_of_denmark
what is the name of the dad of <e> 's children	charles_i_of_england	henrietta_maria_of_france
what is the daughter of spouse of <e>	noble_consort_wan	jiaqing_emperor
what is the <e> 's dad 's nationality	titus_van_rijn	netherlands
what did <e> 's kid die from	john_d_rockefeller_jr	myocardial_infarction
the faith of parent of <e>	muhammad_al-mahdi	shia_islam
what sex is <e> 's offspring	hermann_einstein	female
who is the grandmom of <e>	stephen_i_of_hungary	taksony_of_hungary
the place of death of father of <e>	titus_van_rijn	amsterdam
what faith is <e> 's child	george_of_saxony	roman_catholic_church
what is the sex of heir of <e>	marie_antoinette	female
what is the gender of <e> 's mom	george_formby	male
what is the nation of <e> 's dad	frank_reicher	germany
what is the parents of wife of <e>	juba_ii	cleopatra_vii_of_egypt
<e> 's son 's mother	grand_duke_konstantin_nikolayevich_of_russia	alexandra_iosifovna_of_altenburg
<e> 's mom 's profession	george_grossmith_jr	novelist|singer
what is <e> 's kid	marvin_pentz_gay_sr	composer|record_producer
the nationality of parent of <e>	a_k_faezul_huq	bangladesh
the nationality of <e> 's daughter	john_spencer_churchill_7th_duke_of_marlborough	united_kingdom|england
what is the <e> 's other half 's nationality	edward_blake	canada
<e> 's couple 's gender	phillip_terry	female
what is the <e> 's mom 's gender	thomas_lamb_eliot	male
the faith of <e> 's offspring	hermann_einstein	jew
is <e> 's offspring a man or a woman	frederick_iii_german_emperor	female
what is the name of the couple of <e> 's couple	julie_london	julie_london
what is the gender of <e> 's mom	thomas_lamb_eliot	male
where did the offspring of <e> die	constantine_viii	constantinople
what is the name of the child of <e> 's parent	shah_shuja	shah_shuja
the sex of heir of <e>	marie_antoinette	female
what is the <e> 's children 's heir	wang_khan	mongke_khan
what is the son of kid of <e>	leopold_grand_duke_of_baden	grand_duke_alexei_mikhailovich_of_russia
the sex of offspring of <e>	maria_fyodorovna_of_russia	female
what killed the <e> 's couple	anahareo	pneumonia
what is the sex of <e> 's dad	elena_of_montenegro	male
what is the gender of other half of <e>	talitha_getty	male
who is the children of <e> 's parents	ulysses_s_grant_jr	frederick_dent_grant
what sex is <e> 's kid	christian_x_of_denmark	male
why <e> 's couple died	carole_lombard	myocardial_infarction
where does <e> 's spouse work	virginia_heinlein	united_states_naval_academy
where is <e> 's daughter staying	louise_defeo	new_york_state
who is the children of <e> 's daughter	francis_iv_duke_of_modena	carlos_duke_of_madrid
what is the type of religion of mom of <e>	domenico_tintoretto	catholicism
who is the daughter of <e> 's mom	louise_elisabeth_of_orleans	duc_dorleans
where does <e> 's parent come from	a_k_faezul_huq	bangladesh
what is the husband of husband of <e>	james_hepburn_4th_earl_of_bothwell	francis_ii_of_france
what is the place of birth of wife of <e>	alice_of_bourbon_parma	florence
<e> 's mother 's gender	charlotte_duchess_of_albany	male
<e> 's child 's darling	sam_marx	susan_fleming
where does <e> 's darling come from	edwin_samuel_montagu	united_kingdom
the faith of <e> 's parent	muhammad_al-mahdi	shia_islam
the cause of death of <e> 's kid	nicholas_ii_of_russia	murder|firearm
what is the nationality of other half of <e>	princess_sibylla_of_saxe-coburg_and_gotha	sweden
where does <e> 's darling come from	lew_cody	united_states
is <e> 's son a man or a woman	maximilian_i_of_bavaria	male
the occupation of <e> 's daughter	william_talbot	politician|lawyer
is <e> 's heir a man or a woman	sylvia_likens	male
what is the place of birth of <e> 's mom	vittorio_emanuele_count_of_turin	turin
what religion does <e> 's wife have	mary_josephine_hannon_fitzgerald	catholicism
the nation of dad of <e>	henry_ii_of_england	kingdom_of_england
the address of <e> 's children	johann_conrad_weiser_sr	baden-wurttemberg
what is the sex of <e> 's mother	false_dmitriy_i	male
the wife of <e> 's heir	maria_of_spain	infanta_isabella_clara_eugenia_of_spain
what gender is <e> 's darling	elizabeth_allan_1908	male
<e> 's parent 's gender	thutmose_iv	male
the nationality of spouse of <e>	margaret_of_artois	france
what is the gender of offspring of <e>	gustavus_adolphus_of_sweden	female
what is the <e> 's dad 's place of birth	rudolf_christian_count_of_ostfriesland	aurich
what is the <e> 's kid 's gender	henrietta_anne_stuart	female
the profession of <e> 's parent	wladyslaw_czartoryski	politician
<e> 's parent 's sex	prince_louis_ferdinand_of_bavaria	female
what is the cause of death of child of <e>	adolf_frederick_of_sweden	firearm
what is the nation of <e> 's son	grand_duke_konstantin_nikolayevich_of_russia	russia
what is the sex of offspring of <e>	hermann_einstein	female
what is the name of the daughter of <e> 's mom	louise_elisabeth_of_orleans	duc_dorleans
what religion does <e> 's father follow	george_darwin	anglicanism|agnosticism
what made the <e> 's kiddead	nicholas_ii_of_russia	murder|firearm
what is <e> 's parent 's race about	simeon_uro	serbs
what is the organization of father of <e>	james_a_bayard_jr	princeton_university
what is <e> 's darling working on	elizabeth_blair_lee	naval_officer
where is <e> 's daughter staying	casimir_iv_jagiellon	krakow
where does <e> 's spouse come from	margaret_sullavan	france
where did <e> 's darling born	maria_victoria_al_pozzo_della_cisterna	turin
what is the dad of <e> 's parents	prince_joachim_of_prussia	frederick_iii_german_emperor
what is the nation of <e> 's spouse	bettye_ackerman	united_states
what is the <e> 's child 's nation	edmund_stafford_5th_earl_of_stafford	kingdom_of_england
the occupation of husband of <e>	ronald_reagan	actor
the darling of <e> 's father	henry_viii_of_england	elizabeth_of_york
what is the sex of mother of <e>	rasmus_bartholin	male
the address of children of <e>	johann_conrad_weiser_sr	baden-wurttemberg
the sex of children of <e>	aurangzeb	male
the children of daughter of <e>	p_j_kennedy	rosemary_kennedy
what is the sex of dad of <e>	elena_of_montenegro	male
what is the gender of couple of <e>	maria_luisa_of_savoy	male
what is the sex of <e> 's darling	kalama	male
what is the name of the grandchildren of <e>	tiberius_nero	julius_caesar_drusus
where is <e> 's parents staying	ray_bridwell_white	kentucky
<e> 's children 's gender	nicholas_ii_of_russia	female
what is the sex of <e> 's kid	grand_duke_alexander_mikhailovich_of_russia	male
<e> 's wife 's sex	laura_borden	male
the gender of couple of <e>	ekaterina_svanidze	male
<e> 's parents 's occupation	david_carradine	actor
what is the reason of <e> 's dad 's death	justinus_van_nassau	assassination|firearm
the gender of <e> 's kid	claudine_rhedey_von_kis_rhede	male
what faith does <e> 's heir have	jawaharlal_nehru	hinduism
the nation of child of <e>	edmund_stafford_5th_earl_of_stafford	kingdom_of_england
the gender of couple of <e>	pearl_bailey	male
the gender of <e> 's mom	catharina_of_sweden	male
what is the name of the spouse of <e> 's mom	saovabha	mongkut
what is the name of the dad of <e> 's children	charles_spurgeon	charles_spurgeon
the nation of <e> 's son	grand_duke_konstantin_nikolayevich_of_russia	russia
the nation of <e> 's parent	john_i_of_denmark	germany
the gender of kid of <e>	marie_of_edinburgh	male
where does <e> 's kid work for	anton_philips	delft_university_of_technology
what is the <e> 's mother 's children	henry_i_duke_of_guise	charles_of_lorraine_duke_of_mayenne
the work of <e> 's mother	nissanka_wijeyeratne	diplomat
the sex of mother of <e>	postumus_junior	male
who is the parents of <e> 's daughter	thomas_thynne_2nd_viscount_weymouth	thomas_thynne_2nd_viscount_weymouth
where does <e> 's dad come from	niels_bohr	denmark
what race is <e> 's daughter	marvin_pentz_gay_sr	african_american
the nationality of <e> 's children	marguerite_of_france	england
where does <e> 's wife come from	vilhelmine_marie_of_denmark	denmark
what religion does <e> 's father have	george_darwin	anglicanism|agnosticism
the sex of dad of <e>	princess_elizabeth_of_england	female
<e> 's offspring 's sex	sherman_hoar	male
<e> 's mom 's couple	sunandha	mongkut
what did <e> 's father die from	george_darwin	coronary_thrombosis
what is the <e> 's son 's profession	nathan_mayer_rothschild	politician
what is the parents of <e> 's mom	louis_philippe_i_duke_of_orleans	francoise_marie_de_bourbon
what does <e> 's offspring do for a living	cosima_wagner	conducting|composer
the sex of children of <e>	francis_ii_holy_roman_emperor	female
which nationality is <e> 's mom	henry_howard_7th_duke_of_norfolk	kingdom_of_england|england
what is the occupation of other half of <e>	luis_munoz_marin	first_lady
please tell me <e> 's parents present address	ray_bridwell_white	kentucky
who is the parents of <e> 's wife	juba_ii	cleopatra_vii_of_egypt
what is the name of the darling of <e> 's darling	arcadius	arcadius
what caused the <e> 's father 's death	prince_joachim_of_prussia	pulmonary_embolism
the cause of death of daughter of <e>	nicholas_ii_of_russia	murder|firearm
what is the <e> 's other half 's father	infanta_maria_de_la_paz_of_spain	infanta_amelia_philippina_of_spain
what religion is <e> 's heir	louis_ix_of_france	catholicism
what is <e> 's heir 's race about	major_ridge	cherokee|native_americans_in_the_united_states
the nationality of child of <e>	charles_a_wickliffe	united_states
the kid of <e> 's parents	qianlong_emperor	qianlong_emperor
what is the <e> 's son 's place of birth	ferdinand_maria_elector_of_bavaria	munich
what does <e> 's parents do	david_carradine	actor
the daughter of mom of <e>	laura_marx	jenny_longuet
<e> 's husband 's cause of death	evelyn_keyes	diabetes_mellitus
what is the <e> 's darling 's gender	elizabeth_allan_1908	male
the daughter of <e> 's mom	louise_elisabeth_of_orleans	duc_dorleans
what is the place of death of <e> 's parents	louis_xvi_of_france	chateau_de_fontainebleau
what is the <e> 's wife 's mother	caesonia	germanicus
<e> 's heir 's race	major_ridge	cherokee|native_americans_in_the_united_states
what religious belief does <e> 's father practice	george_darwin	anglicanism|agnosticism
what is the parents of mom of <e>	louis_philippe_i_duke_of_orleans	francoise_marie_de_bourbon
what is the wife of darling of <e>	elizabeth_of_york	elizabeth_of_york
what is the address of <e> 's couple	robert_lowell	london
what is <e> 's wife	verina	eastern_roman_emperor
what does <e> 's father do	henry_viii_of_england	monarch
the nationality of son of <e>	pierre_curie	france
<e> 's child 's place of death	cheryl_crowe	escondido
what is the <e> 's dad 's sex	lady_cynthia_mosley	female
what is the <e> 's daughter 's other half	grand_duchess_alexandra_petrovna	anastasia_of_montenegro
the nation of <e> 's daughter	nathan_mayer_rothschild	united_kingdom
what is the nation of <e> 's other half	marie-anne_pierrette_paulze	united_kingdom|germany
<e> 's couple 's parent	noble_consort_wan	yongzheng_emperor
what sex is <e> 's mother	postumus_junior	male
the sex of offspring of <e>	charles_lennox_1st_duke_of_richmond	male|female
the ethnicity of <e> 's child	yongzheng_emperor	manchu
<e> 's husband 's cause of death	virginia_heinlein	emphysema
what is the nation of <e> 's mom	philip_iii_of_navarre	france
the sex of <e> 's kid	alexander_ferdinand_3rd_prince_of_thurn_and_taxis	male
<e> 's other half 's gender	irina_godunova	male
what is the sex of <e> 's child	svante_nilsson	male
what is the <e> 's kid 's father	charles_a_wickliffe	charles_a_wickliffe
what is the daughter of parents of <e>	infante_joao_of_portugal	infanta_isabel_duchess_of_burgundy
what is <e> 's husband	anna_lee	screenwriter
where does <e> 's kid come from	louise_of_mecklenburg-strelitz	germany
what is the <e> 's wife 's child	charles_i_duke_of_burgundy	mary_of_burgundy
what killed the <e> 's mom	penelope_blount_countess_of_devonshire	dysentery
the nation of <e> 's parent	ramon_berenguer_i_count_of_barcelona	spain
what is the children of <e> 's daughter	p_j_kennedy	rosemary_kennedy
which city did <e> 's child born	archduke_carl_ludwig_of_austria	graz
the race of <e> 's father	princess_tenagnework	oromo
what is the child of <e> 's mom	grand_duke_george_mikhailovich_of_russia	grand_duke_alexei_mikhailovich_of_russia
what is the gender of <e> 's heir	leopold_ii_holy_roman_emperor	male
what is the occupation of parent of <e>	princess_tenagnework	monarch
<e> 's parent 's location	george_darwin	shrewsbury
the gender of <e> 's parent	thutmose_iv	male
the sex of <e> 's mother	techichpotzin	male
where does <e> 's parent come from	david_carradine	united_states
what is the <e> 's spouse 's sex	jeanne_ii_countess_of_burgundy	male
what does <e> 's mother do	nissanka_wijeyeratne	diplomat
what is the place of birth of children of <e>	pierre_curie	paris
the nation of children of <e>	william_backhouse_astor_jr	united_states
what is the location of other half of <e>	auguste_van_pels	lower_saxony
what is the dad of <e> 's children	charles_i_of_england	henrietta_maria_of_france
is <e> 's darling a man or a woman	kalama	male
what is the name of the daughter of <e> 's mom	laura_marx	jenny_longuet
the gender of <e> 's heir	henry_ii_of_france	male
what is the <e> 's child 's job	sigurd_ibsen	film_director|screenwriter
how <e> 's dad died	lynn_redgrave	parkinsons_disease
<e> 's offspring 's children	jahangir	dara_shikoh
what is the <e> 's husband 's husband	james_hepburn_4th_earl_of_bothwell	francis_ii_of_france
the nationality of <e> 's wife	anne_of_york	england
what is the job of <e> 's spouse	richard_mulligan	actor
what is the <e> 's son 's place of death	maria_fyodorovna_of_russia	vienna
what is the profession of husband of <e>	roger_needham	computer_scientist
where does <e> 's child work for	victoria_of_the_united_kingdom	trinity_college_cambridge
<e> 's mother 's heir	marguerite_of_france	louis_devreux
what is the <e> 's child 's occupation	anne_of_denmark	poet
<e> 's offspring 's child	francis_i_of_france	charles_ix_of_france
what is <e> 's spouse working on	evelyn_keyes	composer
what is the name of the wife of <e> 's couple	bobby_troup	bobby_troup
what gender is <e> 's spouse	helena_of_moscow	male
what is the work of <e> 's parents	buster_keaton	actor
what made the <e> 's daughterdead	albert_of_saxe-coburg_and_gotha	infectious_disease
<e> 's kid 's father	charles_a_wickliffe	charles_a_wickliffe
<e> 's spouse 's sex	jeanne_ii_countess_of_burgundy	male
the profession of mom of <e>	george_grossmith_jr	novelist|singer
where did <e> 's mom die	mihailo_obrenovic_iii_prince_of_serbia	belgrade
please tell me <e> 's son present address	frederick_william_i_of_prussia	berlin
what is the organization of <e> 's parent	taufaahau_tupou_iv	new_zealand
what is the race of offspring of <e>	artavasdes_i_of_armenia	armenians
the sex of <e> 's wife	mae_west	male
what is the nationality of darling of <e>	carole_lombard	united_states
the kid of <e> 's offspring	yongzheng_emperor	jiaqing_emperor
what is the sex of kid of <e>	chindasuinth	male
which nationality is <e> 's spouse	roger_needham	united_kingdom
what is the heir of <e> 's mom	felipe_prospero_of_habsburg	john_of_austria_the_younger
the institution of mom of <e>	rasmus_bartholin	university_of_copenhagen
the ethnicity of child of <e>	major_ridge	cherokee|native_americans_in_the_united_states
what is the address of <e> 's son	frederick_william_i_of_prussia	berlin
what religious belief does <e> 's parents follow	mihrimar	islam
what is the profession of <e> 's dad	louis_the_pious	emperor
what is the <e> 's mother 's nation	henry_howard_7th_duke_of_norfolk	kingdom_of_england|england
what is the <e> 's heir 's race	major_ridge	cherokee|native_americans_in_the_united_states
<e> 's couple 's profession	madhubala	singer
what is the <e> 's wife 's occupation	verina	eastern_roman_emperor
where does <e> 's other half work	caroline_webster_schermerhorn_astor	columbia_university
what is the sex of <e> 's darling	lovisa_of_sweden	male
the sex of dad of <e>	lady_cynthia_mosley	female
what is the son of parents of <e>	niels_bohr	harald_bohr
what is the nationality of <e> 's wife	ina_claire	united_states
what is the sex of <e> 's mother	techichpotzin	male
which nationality is <e> 's child	edmund_stafford_5th_earl_of_stafford	kingdom_of_england
what is the sex of son of <e>	maximilian_i_of_bavaria	male
what sex is <e> 's dad	robert_i_duke_of_burgundy	male
<e> 's heir 's nationality	philip_v_of_spain	portugal
what is the <e> 's son 's parent	augusta_of_saxe-weimar	william_i_german_emperor
what is the nationality of <e> 's spouse	margaret_of_artois	france
what is the nation of <e> 's dad	george_grossmith_jr	england
what is the <e> 's couple 's heir	maria_luisa_of_savoy	mariana_victoria_of_spain
the sex of <e> 's child	jewna	male
what caused the <e> 's couple 's death	madhubala	cardiovascular_disease
what is the gender of <e> 's dad	henry_cromwell	female
what is the kid of parents of <e>	qianlong_emperor	qianlong_emperor
the address of <e> 's son	frederick_william_i_of_prussia	berlin
is <e> 's other half a man or a woman	irina_godunova	male
what is <e> 's daughter 's race about	marvin_pentz_gay_sr	african_american
what is the sex of <e> 's mother	postumus_junior	male
what is <e> 's couple 's ethnicity like	george_tabori	swedish_american|swedish_people
<e> 's darling 's place of death	anna_lee	santa_barbara
where does <e> 's mom come from	philip_iii_of_navarre	france
is <e> 's offspring a man or a woman	sherman_hoar	male
<e> 's offspring 's occupation	frances_polidori	illustrator
what gender is <e> 's daughter	joseph_p_kennedy_sr	female
<e> 's parents 's sex	princess_sophia_dorothea_of_prussia	male
the nation of <e> 's dad	george_grossmith_jr	england
what is the nation of <e> 's mother	henry_howard_7th_duke_of_norfolk	kingdom_of_england|england
how <e> 's darling died	ida_lupino	lung_cancer
which nationality is <e> 's daughter	roy_thomson_1st_baron_thomson_of_fleet	canada
<e> 's husband 's gender	samuel_pepys	female
what is the <e> 's kid 's gender	louis_xvi_of_france	female
<e> 's parents 's dad	prince_joachim_of_prussia	frederick_iii_german_emperor
<e> 's wife 's sex	mae_west	male
what is the nationality of <e> 's kid	hortense_de_beauharnais	france
<e> 's daughter 's profession	john_a_roebling	engineer
the parent of couple of <e>	noble_consort_wan	yongzheng_emperor
what is the <e> 's couple 's profession	madhubala	singer
what is the <e> 's children 's place of birth	archduchess_maria_beatrix_of_austria_este	ljubljana
what is the heir of mom of <e>	jenny_longuet	jenny_longuet
what sex is <e> 's couple	chilperic_i	female
what is the wife of dad of <e>	henry_ii_of_england	henry_v_holy_roman_emperor
what is the <e> 's children 's nation	james_otis_sr	united_states
what sex is <e> 's husband	matilda_of_flanders	male
what did <e> 's dad die from	lynn_redgrave	parkinsons_disease
what is the religion of heir of <e>	louis_ix_of_france	catholicism
the gender of mother of <e>	anne_of_cleves	male
the organization of other half of <e>	laura_devon	university_of_notre_dame|university_of_michigan
what did <e> 's husband die from	evelyn_keyes	diabetes_mellitus
what is the name of the kid of <e> 's offspring	yongzheng_emperor	jiaqing_emperor
what is the name of the grandheir of <e>	christiane_eberhardine_of_brandenburg_bayreuth	marie_josephe_of_saxony
what is the <e> 's children 's place of death	ahaz	jerusalem
what is the religious belief of <e> 's spouse	cecilia_renata_of_austria	catholicism
what is the sex of <e> 's offspring	maria_of_spain	male
<e> 's children 's nation	frank_lloyd_wright	united_states
what is the son of kid of <e>	alexandre_vicomte_de_beauharnais	napoleon_iii_of_france
the gender of <e> 's children	prince_alexander_of_hesse_and_by_rhine	male
which nationality is <e> 's heir	gustaf_vi_adolf_of_sweden	sweden
what is the child of <e> 's parent	prince_feodor_alexandrovich_of_russia	prince_andrei_alexandrovich_of_russia
the ethnicity of <e> 's mom	cleopatra_selene	greeks_in_egypt
<e> 's other half 's gender	grand_duchess_elizabeth_mikhailovna	male
the heir of mother of <e>	diego_colon	fernando_colon
<e> 's parents 's sex	otto_i_duke_of_saxony	male
what is the <e> 's darling 's wife	elizabeth_of_york	elizabeth_of_york
what made the <e> 's spousedead	phillip_terry	pancreatic_cancer
<e> 's darling 's nation	alva_belmont	united_states
what is the <e> 's mom 's spouse	saovabha	mongkut
what is the name of the grandmother of <e>	marguerite_of_france	henry_iii_duke_of_brabant
what does <e> 's dad do for a living	louis_the_pious	emperor
what is <e> 's wife working on	ernest_hemingway	journalist
what is the father of <e> 's other half	infanta_maria_de_la_paz_of_spain	infanta_amelia_philippina_of_spain
what is the institution of <e> 's kid	anton_philips	delft_university_of_technology
<e> 's son 's job	john_b_kelly_sr	fashion_model
what gender is <e> 's dad	henry_cromwell	female
what is the gender of <e> 's mom	mieszko_iv_tanglefoot	male
what is the nationality of wife of <e>	marie-anne_pierrette_paulze	united_kingdom|germany
<e> 's kid 's gender	anton_philips	male
the gender of <e> 's mother	pearl_starr	female
what is the nationality of daughter of <e>	john_spencer_churchill_7th_duke_of_marlborough	united_kingdom|england
the parents of daughter of <e>	thomas_thynne_2nd_viscount_weymouth	thomas_thynne_2nd_viscount_weymouth
the other half of <e> 's other half	alexander_darcy	alexander_darcy
what is the daughter of <e> 's parents	infante_joao_of_portugal	infanta_isabel_duchess_of_burgundy
what faith is <e> 's offspring	hermann_einstein	jew
what is the mom of darling of <e>	georg_donatus_hereditary_grand_duke_of_hesse	prince_andrew_of_greece_and_denmark
the race of darling of <e>	margaret_sullavan	jew
what is the sex of offspring of <e>	maria_fyodorovna_of_russia	female
the place of death of children of <e>	ahaz	jerusalem
the place of birth of <e> 's mom	adolphus_busch_iii	st_louis_missouri
what is <e> 's child working on	anne_of_denmark	poet
<e> 's heir 's gender	charles_i_of_england	female
who is the grandson of <e>	j_presper_eckert	j_presper_eckert
<e> 's children 's institution	roy_thomson_1st_baron_thomson_of_fleet	upper_canada_college
<e> 's wife 's cause of death	franz_joseph_i_of_austria	assassination
what is the name of the darling of <e> 's husband	robert_e_lee	robert_e_lee
what is the daughter of <e> 's spouse	noble_consort_wan	jiaqing_emperor
what does <e> 's parents do	j_p_morgan_jr	financier
the kid of father of <e>	princess_tenagnework	princess_tsehai
where is <e> 's heir staying	hermann_einstein	italy
the profession of child of <e>	gheorghe_i_tasca	politician
what is the son of <e> 's parent	thomas_thynne_1st_marquess_of_bath	thomas_thynne_1st_marquess_of_bath
<e> 's daughter 's work	alexandra_fyodorovna_of_hesse	grand_duchess
the religion of <e> 's spouse	edwin_samuel_montagu	judaism
what is the husband of <e> 's husband	james_hepburn_4th_earl_of_bothwell	francis_ii_of_france
who is the offspring of <e> 's dad	william_ii_german_emperor	princess_charlotte_of_prussia
what does <e> 's offspring do for a living	frances_polidori	illustrator
what is the <e> 's children 's profession	william_talbot	politician|lawyer
what is the <e> 's dad 's sex	princess_elizabeth_of_england	female
<e> 's kid 's profession	sigurd_ibsen	film_director|screenwriter
the cause of death of husband of <e>	virginia_heinlein	emphysema
the child of <e> 's parent	thomas_spurgeon	thomas_spurgeon
what is the <e> 's heir 's religion	louis_ix_of_france	catholicism
what is the gender of <e> 's husband	martha_bulloch	male
the religion of <e> 's other half	madhubala	hinduism
what is the <e> 's wife 's father	aelia_eudoxia	theodosius_i
the sex of <e> 's daughter	william_of_winchester_lord_of_lunenburg	male
what is the <e> 's parent 's location	george_darwin	shrewsbury
what is the <e> 's child 's nationality	leonard_jerome	united_states
what is the gender of <e> 's darling	louise_juliana_of_nassau	male
where does <e> 's parent come from	edward_of_norwich_2nd_duke_of_york	kingdom_of_england
what is the parents of heir of <e>	charles_lennox_1st_duke_of_richmond	charles_lennox_1st_duke_of_richmond
what is the name of the husband of <e> 's son	marie_of_edinburgh	archduke_anton_prince_of_tuscany
the profession of <e> 's parents	j_p_morgan_jr	financier
what is the <e> 's daughter 's nation	nathan_mayer_rothschild	united_kingdom
the sex of offspring of <e>	sherman_hoar	male
what is the name of the grandchild of <e>	francis_i_of_france	charles_ix_of_france
the children of offspring of <e>	jahangir	dara_shikoh
the gender of other half of <e>	benjamin_harrison	female
which nationality is <e> 's parent	ramon_berenguer_i_count_of_barcelona	spain
is <e> 's offspring a man or a woman	charles_lennox_1st_duke_of_richmond	male|female
the sex of <e> 's husband	grand_duke_peter_nicolaievich_of_russia	female
what is the couple of <e> 's couple	julie_london	julie_london
what is the children of mother of <e>	henry_i_duke_of_guise	charles_of_lorraine_duke_of_mayenne
<e> 's daughter 's location	john_elector_of_saxony	coburg
the place of death of parents of <e>	princess_margaret_of_prussia	potsdam
what is the spouse of <e> 's husband	mary_anna_custis_lee	mary_anna_custis_lee
what is the place of death of heir of <e>	francis_iv_duke_of_modena	graz
what is <e> 's couple working on	madhubala	singer
what is the work of <e> 's father	mette_marit_crown_princess_of_norway	journalist
who is the granddaughter of <e>	marguerite_of_france	elizabeth_of_rhuddlan
what sex is <e> 's dad	lothair_of_france	female
what gender is <e> 's kid	sarah_lennox_duchess_of_richmond	male
what is the type of religion of <e> 's heir	alice_betty_stern	jew
what is the <e> 's spouse 's gender	helena_of_moscow	male
what is <e> 's son 's birthplace	ferdinand_maria_elector_of_bavaria	munich
what is the daughter of <e> 's dad	princess_sophia_dorothea_of_prussia	frederick_ii_of_prussia
the place of death of <e> 's darling	elizabeth_allan_1908	new_york
the gender of darling of <e>	franz_joseph_i_of_austria	female
the job of <e> 's kid	thomas_thynne_2nd_viscount_weymouth	politician
<e> 's darling 's gender	richard_mulligan	female
what is the <e> 's child 's nationality	john_d_rockefeller_jr	united_states
what is the <e> 's other half 's gender	irina_godunova	male
the profession of <e> 's wife	alexander_darcy	actor
what gender is <e> 's mother	philip_ii_of_taranto	male
what does <e> 's husband do	colleen_dewhurst	actor
the nation of <e> 's spouse	margaret_sullavan	france
the father of <e> 's daughter	louis_iv_of_france	gerberga_of_saxony
the parent of parents of <e>	william_kissam_vanderbilt	cornelius_vanderbilt
what is the gender of child of <e>	john_v_palaiologos	male
<e> 's children 's sex	francis_ii_holy_roman_emperor	female
where did <e> 's son die	francis_i_of_france	paris
who is the child of <e> 's child	albert_of_saxe-coburg_and_gotha	victoria_eugenia_of_battenberg|prince_maurice_of_battenberg
what is the <e> 's parent 's race	simeon_uro	serbs
the son of <e> 's parent	archduke_louis_of_austria	rudolf_cardinal_von_habsburg_lothringen|archduke_joseph_of_austria_palatine_of_hungary
what is the mom of <e> 's darling	georg_donatus_hereditary_grand_duke_of_hesse	prince_andrew_of_greece_and_denmark
what is the organization of other half of <e>	laura_devon	university_of_notre_dame|university_of_michigan
what is the <e> 's offspring 's work	cosima_wagner	conducting|composer
the nationality of wife of <e>	anne_of_york	england
the nationality of <e> 's heir	philip_v_of_spain	portugal
what is <e> 's mom 's birthplace	henry_iii_of_france	florence
what sex is <e> 's mother	hussein_of_jordan	male
what is the <e> 's parent 's nation	david_carradine	united_states
what is the <e> 's children 's job	princess_margaret_of_connaught	prince
what is the nation of son of <e>	princess_beatrice_of_the_united_kingdom	united_kingdom
<e> 's other half 's wife	arleen_whelan	arleen_whelan
what is the sex of children of <e>	marguerite_of_france	female
what is the nationality of spouse of <e>	roger_needham	united_kingdom
what line of business is <e> 's dad in	anna_e_roosevelt	social_activist
what is the <e> 's darling 's educational institution	effie_gray	christ_church_oxford
what is <e> 's heir 's birthplace	jawaharlal_nehru	allahabad
the gender of <e> 's heir	jahangir	male
what is the name of the couple of <e> 's kid	alice_spencer	henry_hastings_5th_earl_of_huntingdon
what religion is <e> 's spouse	edwin_samuel_montagu	judaism
what is the <e> 's son 's nationality	frederick_william_i_of_prussia	germany
what is the nationality of <e> 's son	frederick_william_i_of_prussia	germany
<e> 's parents 's gender	andrey_bolshoy	male
the religion of <e> 's father	george_darwin	anglicanism|agnosticism
what gender is <e> 's kid	henrietta_anne_stuart	female
<e> 's offspring 's place of death	maria_theresa_of_austria	vienna
is <e> 's children a man or a woman	francis_ii_holy_roman_emperor	female
what is the spouse of <e> 's mom	henry_i_duke_of_guise	jacques_de_savoie_2nd_duc_de_nemours
the father of daughter of <e>	ellen_terry	edward_william_godwin
who is the grandmother of <e>	christian_ii_of_denmark	dorothea_of_brandenburg
what type of religion does <e> 's wife follow	james_hepburn_4th_earl_of_bothwell	catholicism
<e> 's heir 's husband	philip_v_of_spain	joseph_i_of_portugal
<e> 's children 's gender	prince_alexander_of_hesse_and_by_rhine	male
where does <e> 's child come from	leonard_jerome	united_states
what is the sex of dad of <e>	constantine_xi	male
where does <e> 's children come from	marguerite_of_france	england
the gender of heir of <e>	henry_ii_of_france	male
what is the <e> 's son 's cause of death	anton_philips	accidental_fall
which organization does <e> 's parent work for	taufaahau_tupou_iv	new_zealand
the nation of <e> 's dad	frank_reicher	germany
is <e> 's heir a man or a woman	leopold_ii_holy_roman_emperor	male
where does <e> 's darling work for	juliette_peirce	harvard_university
what is the <e> 's other half 's gender	samuel_gridley_howe	male|female
what line of business is <e> 's children in	william_talbot	politician|lawyer
what is the <e> 's darling 's nation	margaret_mead	united_states
the place of death of offspring of <e>	augustus_ii_the_strong	avignon
what did <e> 's father die from	prince_joachim_of_prussia	pulmonary_embolism
the nation of <e> 's wife	robert_anderson_1917	united_states
what is the <e> 's kid 's gender	frank_lloyd_wright	male
what is the sex of <e> 's other half	juba_ii	female
what is the gender of offspring of <e>	artavasdes_i_of_armenia	male
what is the institution of darling of <e>	juliette_peirce	harvard_university
what is the cause of death of <e> 's kid	nicholas_ii_of_russia	murder|firearm
<e> 's couple 's work	arthur_de_wint_foote	writer
what city did <e> 's mom die	mihailo_obrenovic_iii_prince_of_serbia	belgrade
<e> 's husband 's sex	henrietta_anne_stuart	male
what is the <e> 's child 's gender	henry_iii_holy_roman_emperor	male
what is the name of the heir of <e> 's mother	frits_philips	frits_philips
<e> 's mom 's daughter	leonora_of_england	geoffrey_ii_duke_of_brittany
<e> 's parent 's nation	edward_ellice_1810	united_kingdom
what is the child of wife of <e>	charles_i_duke_of_burgundy	mary_of_burgundy
what faith is <e> 's son	christiane_eberhardine_of_brandenburg_bayreuth	catholicism
where did <e> 's offspring die	archduchess_maria_beatrix_of_austria_este	varese
which city did <e> 's mom born	henry_iii_of_france	florence
what caused the <e> 's other half 's death	adolf_hitler	suicide|cyanide_poisoning
what is the sex of <e> 's children	marguerite_of_france	female
what is the <e> 's spouse 's nation	bettye_ackerman	united_states
the gender of <e> 's mother	philip_ii_of_taranto	male
what sex is <e> 's kid	chindasuinth	male
what is the place of death of daughter of <e>	george_iii_of_the_united_kingdom	windsor_castle
what is the <e> 's mom 's daughter	laura_marx	jenny_longuet
what is <e> 's mom working on	george_grossmith_jr	novelist|singer
what is the sex of <e> 's darling	colleen_dewhurst	male
the sex of <e> 's darling	joseph_e_davies	female
the place of birth of <e> 's children	archduchess_maria_beatrix_of_austria_este	ljubljana
what killed the <e> 's other half	adolf_hitler	suicide|cyanide_poisoning
please tell me <e> 's daughter present address	john_elector_of_saxony	coburg
the nation of couple of <e>	julie_london	united_states
what is the sex of parent of <e>	penelope_blount_countess_of_devonshire	male
what sex is <e> 's parents	ludwig_ii_of_bavaria	male
what sex is <e> 's child	david_kawananakoa	female
what faith does <e> 's husband follow	marie-anne_pierrette_paulze	anglicanism
what is the <e> 's father 's son	charles_duke_of_lower_lorraine	lothair_of_france
what is the gender of parent of <e>	princess_margaret_of_prussia	male
the mother of <e> 's son	william_starling_burgess	william_starling_burgess
the nationality of child of <e>	grand_duke_michael_mihailovich_of_russia	united_kingdom
what made the <e> 's daddead	justinus_van_nassau	assassination|firearm
<e> 's mom 's nationality	george_formby	england
why <e> 's dad died	louise_juliana_of_nassau	assassination|firearm
what is the sex of darling of <e>	luis_munoz_marin	female
what is the race of <e> 's parent	chagatai_khan	mongols
what is the sex of <e> 's wife	huey_long	female
<e> 's child 's gender	augusta_viktoria_of_schleswig-holstein	male
the nation of spouse of <e>	luz_magsaysay	philippines
who is the grandmom of <e>	princess_amelia_sophia_of_great_britain	george_i_of_great_britain
what is the <e> 's daughter 's place of death	anne_marie_martinozzi	fontainebleau
the wife of dad of <e>	henry_ii_of_england	henry_v_holy_roman_emperor
what is the <e> 's parents 's sex	tyrone_power	male
<e> 's couple 's nation	julie_london	united_states
is <e> 's father a man or a woman	frederick_v_of_denmark	female
what is the job of <e> 's child	sigurd_ibsen	film_director|screenwriter
what is the <e> 's daughter 's parents	jenny_von_westphalen	jenny_von_westphalen
what is the daughter of <e> 's parent	takelot_iii	takelot_iii
what is the place of death of <e> 's kid	princess_beatrice_of_the_united_kingdom	lausanne
the son of child of <e>	j_presper_eckert	j_presper_eckert
the type of religion of dad of <e>	j_p_morgan_jr	anglicanism
the gender of spouse of <e>	ptolemy_ix_lathyros	female
what is the gender of kid of <e>	frank_lloyd_wright	male
the son of <e> 's child	j_presper_eckert	j_presper_eckert
is <e> 's heir a man or a woman	charles_i_of_england	female
what is the sex of <e> 's son	archduchess_maria_beatrix_of_austria_este	male
what is the name of the offspring of <e> 's offspring	grand_duchess_alexandra_petrovna	princess_nadejda_petrovna_of_russia
is <e> 's spouse a man or a woman	carlos_thompson	female
what is the <e> 's parents 's gender	natalia_alexeievna_of_russia	female
what is <e> 's son working on	john_b_kelly_sr	fashion_model
<e> 's couple 's sex	lew_cody	female
what is the gender of <e> 's darling	empress_xiaoquan_cheng	male
is <e> 's daughter a man or a woman	yaroslav_i_the_wise	male
what does <e> 's heir do for a living	henry_iv_of_england	monarch
how <e> 's dad died	justinus_van_nassau	assassination|firearm
<e> 's darling 's sex	samuel_gridley_howe	male|female
the cause of death of dad of <e>	lynn_redgrave	parkinsons_disease
what is the occupation of <e> 's wife	verina	eastern_roman_emperor
what is the <e> 's heir 's faith	jawaharlal_nehru	hinduism
the sex of <e> 's parent	penelope_blount_countess_of_devonshire	male
what line of business is <e> 's child in	anne_of_denmark	poet
which educational institution does <e> 's other half work for	caroline_webster_schermerhorn_astor	columbia_university
what is the darling of other half of <e>	joseph_e_davies	joseph_e_davies
the parents of child of <e>	anton_philips	anton_philips
what is the <e> 's son 's child	duke_peter_of_oldenburg	grand_duke_peter_nicolaievich_of_russia|grand_duke_nicholas_nicolaevich_the_younger
what is the sex of <e> 's children	michael_i_rangabe	male
<e> 's kid 's sex	alexander_ferdinand_3rd_prince_of_thurn_and_taxis	male
what is the gender of <e> 's children	princess_beatrice_of_the_united_kingdom	male
what is the parent of son of <e>	anna_of_holstein-gottorp	enno_iii_count_of_ostfriesland
what is the gender of <e> 's heir	jahangir	male
what is the name of the grandparents of <e>	henry_iii_of_france	madeleine_de_la_tour_dauvergne
what is the couple of mom of <e>	sunandha	mongkut
what is the gender of <e> 's parents	lady_louisa_stuart	male
what does <e> 's other half do for a living	elizabeth_of_york	monarch
what gender is <e> 's son	charles_ii_of_austria	female
the type of religion of <e> 's daughter	franz_josef_i_prince_of_liechtenstein	catholicism
what is the work of kid of <e>	emperor_temmu	writer
the daughter of parent of <e>	louis_of_bourbon_duke_of_orleans	duc_dorleans
which nationality is <e> 's wife	anne_of_york	england
<e> 's parents 's nationality	edward_salisbury_dana	united_states
what is the <e> 's mom 's nationality	vratislaus_ii_of_bohemia	germany
what is the <e> 's darling 's nation	edwin_samuel_montagu	united_kingdom
the sex of parent of <e>	claudius	male
what is the nationality of children of <e>	marguerite_of_france	england
what is the <e> 's dad 's gender	frederick_edward_guest	male
what faith does <e> 's heir follow	jawaharlal_nehru	hinduism
what is the <e> 's mom 's gender	george_formby	male
what did <e> 's daughter die from	albert_of_saxe-coburg_and_gotha	infectious_disease
how <e> 's daughter died	albert_of_saxe-coburg_and_gotha	infectious_disease
the nationality of other half of <e>	edward_blake	canada
what is <e> 's parent 's race like	chagatai_khan	mongols
what is <e> 's spouse 's race about	elizabeth_de_burgh	scottish_people
what is the <e> 's darling 's ethnicity	george_tabori	swedish_american|swedish_people
what is <e> 's kid	cosima_wagner	conducting|composer
the son of <e> 's father	maria_antonia_of_portugal	maria_josepha_of_portugal
<e> 's offspring 's race	artavasdes_i_of_armenia	armenians
the educational institution of <e> 's darling	effie_gray	christ_church_oxford
what is the sex of parents of <e>	otto_i_duke_of_saxony	male
the sex of child of <e>	wang_khan	female
what is <e> 's parent	wladyslaw_czartoryski	politician
who is the heir of <e> 's couple	maria_luisa_of_savoy	mariana_victoria_of_spain
the ethnicity of <e> 's wife	noble_consort_wan	manchu
where does <e> 's husband work for	laura_devon	university_of_notre_dame|university_of_michigan
is <e> 's son a man or a woman	charles_ii_of_austria	female
the nationality of <e> 's mom	vratislaus_ii_of_bohemia	germany
<e> 's mother 's sex	rasmus_bartholin	male
the sex of <e> 's heir	sylvia_likens	male
the sex of <e> 's mother	niels_bohr	male
what is the sex of <e> 's other half	anna_radziwill	male
<e> 's child 's institution	victoria_of_the_united_kingdom	trinity_college_cambridge
the heir of mom of <e>	jenny_longuet	jenny_longuet
<e> 's darling 's nationality	carole_lombard	united_states
what is the <e> 's children 's sex	marguerite_of_france	female
what is the sex of <e> 's offspring	leonard_jerome	female
<e> 's offspring 's sex	leonard_jerome	female
what is the address of <e> 's children	augusta_viktoria_of_schleswig-holstein	potsdam
what city did <e> 's offspring die	maria_luisa_of_parma	trieste
where did <e> 's wife born	alice_of_bourbon_parma	florence
the gender of father of <e>	mikolaj_vii_radziwill	female
what is the gender of <e> 's children	nicholas_ii_of_russia	female
what is the <e> 's kid 's profession	marvin_pentz_gay_sr	composer|record_producer
